ABACUS	ABCS
ABCS	ABCS
ABOVE	ABV
ABV	ABV
ABRASIVE	ABR
ABR	ABR
ABRSV	ABR
ABROAD	ABRD
ABRD	ABRD
ABSOLUTE	ABSLT
ABSLT	ABSLT
ABSTRACT	ABSTRCT
ABSTRCT	ABSTRCT
ACADEMIC	ACDMC
ACDMC	ACDMC
ACADEMY	ACDMY
ACAD	ACDMY
ACADEM	ACDMY
ACDMY	ACDMY
ACCESS	ACCSS
ACCSS	ACCSS
ACCESSORY	ACC
ACC	ACC
ACCIDENT	ACDNT
ACC	ACDNT
ACDNT	ACDNT
ACCOMPLISHMENT	ACCMPLSMNT
ACCMPLSSMNT	ACCMPLSMNT
ACCOUNT	ACCT
AC	ACCT
ACC	ACCT
ACCNT	ACCT
ACCONT	ACCT
ACCT	ACCT
ACCUNT	ACCT
ACNT	ACCT
ACCOUNTANCY	ACCTNCY
ACC	ACCTNCY
ACCOUNTANC	ACCTNCY
ACCOUNTY	ACCTNCY
ACCTNCY	ACCTNCY
ACCOUNTANT	ACCNT
AC	ACCNT
ACC	ACCNT
ACCNT	ACCNT
ACCT	ACCNT
ACCTANT	ACCNT
ACCTNT	ACCNT
ACT	ACCNT
ACCOUNTING	ACCTG
ACCTG	ACCTG
ACCTNG	ACCTG
ACTG	ACCTG
ACCREDITED	ACCRDTD
ACCRDTD	ACCRDTD
ACCREDITATION	ACCRDTN
ACCRDTN	ACCRDTN
ACCURACY	ACCRCY
ACCRCY	ACCRCY
ACCURATE	ACCRT
ACCRT	ACCRT
ACHIEVEMENT	ACHVMNT
ACHVMNT	ACHVMNT
ACOUSTIC	ACSTC
ACSTC	ACSTC
ACQUISITION	ACQSTN
ACQSTN	ACQSTN
ACQUIS	ACQSTN
ACROSS	ACR
ACR	ACR
ACTING	ACTNG
ACTNG	ACTNG
ACTION	ACTN
ACTN	ACTN
ACTIVITY	ACTVTY
ACTVT	ACTVTY
ACTVTY	ACTVTY
ACTOR	ACTR
ACTR	ACTR
ACTUARY	ACTRY
ACTRY	ACTRY
ACTUARIAL	ACTRL
ACTRL	ACTRL
ACTURIAL	ACTRL
ACUPUNCTURE	ACPNCTR
ACPNCTR	ACPNCTR
ADDITION	ADDTN
ADDTN	ADDTN
ADDRESS	ADDR
ADDR	ADDR
ADHESIVE	ADHSV
ADHSV	ADHSV
ADJUSTER	ADJTER
ADJ	ADJTER
ADJT	ADJTER
ADJTER	ADJTER
ADJUSTMENT	ADJMT
ADJMT	ADJMT
ADJUSTOR	ADJTOR
ADJ	ADJTOR
ADJT	ADJTOR
ADJTOR	ADJTOR
ADJUTANT	ADJT
ADJ	ADJT
ADJT	ADJT
ADMINISTRATION	ADMN
AD	ADMN
ADM	ADMN
ADMIN	ADMN
ADMINIST	ADMN
ADMINISTRATI	ADMN
ADMINISTRATN	ADMN
ADMN	ADMN
ADMSTRN	ADMN
ADMINISTRATIVE	ADMNSTRV
AD	ADMNSTRV
ADMIN	ADMNSTRV
ADMINI	ADMNSTRV
ADMINISTRATV	ADMNSTRV
ADMSTR	ADMNSTRV
ADMINISTRATOR	ADMNSTR
ADMIN	ADMNSTR
ADMINISTR	ADMNSTR
ADMINISTRA	ADMNSTR
ADMINISTER	ADMNSTR
ADMINSTR	ADMNSTR
ADMR	ADMNSTR
ADMSTR	ADMNSTR
ADMIRAL	ADM
ADM	ADM
ADOPTION	ADPTN
ADPTN	ADPTN
ADROIT	ADRT
ADRT	ADRT
ADULT	ADLT
ADLT	ADLT
ADVANCE	ADVNC
ADVNC	ADVNC
ADVANCED	ADVNCD
ADV	ADVNCD
ADVNCD	ADVNCD
ADVANCEMENT	ADVMNT
ADVMNT	ADVMNT
ADVENTURE	ADVNTR
ADVNTR	ADVNTR
ADVERTISE	ADVT
ADVT	ADVT
ADVERTISEMENT	AD
AD	AD
ADV	AD
ADVERTISING	ADVTSNG
AD	ADVTSNG
ADV	ADVTSNG
ADVERT	ADVTSNG
ADVERTISIN	ADVTSNG
ADVERTISNG	ADVTSNG
ADVG	ADVTSNG
ADVR	ADVTSNG
ADVTG	ADVTSNG
ADVTNG	ADVTSNG
ADVTSNG	ADVTSNG
ADVISER	ADVSR
ADV	ADVSR
ADVSER	ADVSR
ADVSR	ADVSR
ADVISOR	ADVSR
ADVSOR	ADVSR
ADVISORY	ADVRY
ADV	ADVRY
AERIAL	ARL
ARL	ARL
AERONAUTICAL	ARNTCL
ARNTCL	ARNTCL
AEROSPACE	ARSPC
ARSPC	ARSPC
AS	ARSPC
AEROSTAT	ARSTT
ARSTT	ARSTT
AESTHETIC	ASTHTC
ASTHTC	ASTHTC
AFFAIR	AFFR
AFFR	AFFR
AFFILIATE	AFFLT
AFFLT	AFFLT
AFFILIATED	AFFLTD
AFFLTD	AFFLTD
AFRICAN	AFRCN
AFRCN	
AGCY	AGNCY
AGNT	AGT
AGGRGT	AGGRGT
AGNG	AGNG
AGRCLTL	AGRCLTRL
AGRCLT	AGRCLT
AID	AID
AC	ARCNDTNG
ARCRFT	ARCRFT
ARLN	ARLN
ARMN	ARMN
ARPRT	ARPT
ARWY	ARWY
ALRM	ALRM
ALCHLC	ALCHLC
ALCHLSM	ALCHLSM
ALDM	ALDM
ALGNR	ALGNR
ALGNNG	ALGNNG
ALIGN	ALIMENT
ALLRGST	ALLRGST
ALLRGY	ALLRGY
ALLNCE	ALLNCE
ALLD	ALLIE
ALLCT	ALLCT
ALLCTN	ALLCTN
ALLY	ALLY
ALPH	ALPH
ALTR	ALTR
ALTRN	ALTER
ALTRNTV	ALTRNTV
ALTRNTR	ALTRNTR
ALTTD	ALTTD
ALUMN	ALUM
AMTR	AMTR
AMB	AMB
AMBNC	AMBNC
AMBL	AMBL
AMLRTN	AMLRTN
AMER	AMER
AMERCN	AMERCN
AMMN	AMMN
AMMUN	AMMUN
AMNT	AMNT
AMPHBS	AMPHBS
AMUSE	AMUSE
ANLG	ANLG
ANLYS	ANLYS
ANLYST	ANLYST
ANLYTC	ANLYTC
ANLYTCL	ANLYTCL
ANCHR	ANCHR
ANCNT	ANCNT
&amp;	&amp;&amp;
ANSTHS	ANSTHS
ANSTHSLGY	ANSTHSLGY
ANGL	ANGL
ANGLR	ANGLR
ANGLCN	ANGLCN
ANML	ANML
ANMTD	ANMTD
ANX	ANNX
ANON	ANNYMS
ANNL	ANNL
ANDZNG	ANDZNG
ANSWRNG	ANSWRNG
ANTQ	ANTQ
APT	APT
APSTLT	APSTLT
APSTLC	APSTLC
APPRTS	APPRTS
APPRL	APPRL
APPLE	APPLE
APPLNC	APPLNC
APPLCTN	APPLCTN
APPLCTR	APPLCTR
APPLD	APPLD
APPLQ	APPLQ
APPNTD	APPNTD
APPRSL	APRSL
APPRSER	APPRSR
APPRSOR	APPRSR
APPRNTC	APPRNTC
APPRCHR	APPRCHR
ARBN	ARBN
ARC	ARCD
ABP	ARCHS
ARCHRY	ARCHRY
ARCHT	ARCHTCT
ARCHL	ARCHL
ARCH	ARCH
ARCHV	ARCHV
ARN	ARN
ARSTCRT	ARSTCRT
ARMDLL	ARMDLL
ARMTR	ARMTR
ARMD	ARMD
ARMRD	ARMRD
ARMRY	ARMRY
ARW	ARW
ARSNL	ARSNL
ARTRY	ARTRY
ARTFL	ARTIFCAL
ARTSN	ARTSN
ART	ART
ARTSTC	ARTSTC
ARTSTRY	ARTSTRY
ASB	ASB
ASPHLT	ASPHLT
ASSMBL	ASSEMBLE
ASSMBLR	ASSMBLR
ASMBLY	ASSEM
ASST	ASST
ASSGN	ASSGN
ASSTNCE	ASSTNCE
ASSIST	AST
ASSOC	ASST
ASSOCD	ASSOD
ASSN	ASSOC
ASSMPTN	ASSMPTN
ASSURNC	ASSURNC
ASSUR	ASSUR
ASTRNTC	ASTRNTC
ATHL	ATHL
ATL	ATLNTC
ATLS	ATLS
ATMC	ATMC
ATT	ATT
ATTNDNT	ATTNDNT
ATTN	ATTNTN
ATTC	ATTC
ATTTD	ATTTD
ATTY	ATY
AUCT	AUCTN
AUCTNR	AUCTNR
ACTNRG	ACTNRG
AUD	AUD
AUDLGST	AUDLGST
AUDLGY	AUDLGY
AUDIOPR	AUDPROT
AUDT	AUDT
ADTNG	ADTNG
AUDTR	AUDTR
ADTRM	ADTRM
ATHRTY	AUTHY
AUTOM	AUTOM
AUTOMTC	AUTOMTC
AUTOMTN	AUTOMTN
AUTO	AUTO
AUTOMTV	AUTOMTV
AUX	AUXILRY
AVLBLTY	AVLBLTY
AVE	AVE
AVN	AVN
AVNC	AVNC
AWRD	AWRD
AWN	AWNG
BCHLR	BCHLR
BCKHOE	BCKHOE
BGTTL	BGTTL
BLG	BLG
BKD	BAKED
BAKER	BKR
BKR	BKR
BAKERY	BKRY
BKRY	BKRY
BKY	BKRY
BAKING	BKG
BKG	BKG
BALANCE	BAL
BAL	BAL
BALANCING	BALNCNG
BALNCNG	BALNCNG
BALLER	BLLR
BLLR	BLLR
BALLOON	BLN
BLN	BLN
BALLROOM	BLLRM
BLLRM	BLLRM
BANK	BK
BK	BK
BANKER	BNKR
BKR	BNKR
BNKR	BNKR
BANKING	BNKNG
BNKG	BNKNG
BNKNG	BNKNG
BAPTIST	BAPT
BAPT	BAPT
BPTST	BAPT
BARBEQUE	BBQ
BAR B Q	BBQ
BAR BQ	BBQ
BARBQUE	BBQ
BBQ	BBQ
BARBER	BARB
BARB	BARB
BARBR	BARB
BARGAIN	BRGN
BRGN	BRGN
BARREL	BRL
BRL	BRL
BARRISTER	BRRSTR
BRRSTR	BRRSTR
BASEBALL	BSBLL
BSBLL	BSBLL
BASEMENT	BSMNT
BSMNT	BSMNT
BASIC	BSC
BSC	BSC
BASKET	BSK
BSK	BSK
BASKETBALL	BSKTBLL
BSKTBLL	BSKTBLL
BATTERY	BATT
BATT	BATT
BTRY	BATT
BAZAAR	BZR
BZR	BZR
BEACH	BCH
BCH	BCH
BEARING	BRNG
BRNG	BRNG
BEAUTICIAN	BTCN
BTCN	BTCN
BEAUTY	BTY
BTY	BTY
BUTY	BTY
BEAVER	BVR
BVR	BVR
BEDDING	BEDG
BEDG	BEDG
BEGINNING	BGNG
BGNG	BGNG
BEHAVIORAL	BHVRL
BHVRL	BHVRL
BENEFICE	BNFC
BNFC	BNFC
BENEFICIAL	BNFCL
BNFCL	BNFCL
BENEFIT	BNFT
BNFT	BNFT
BENEVOLENT	BNVLNT
BNVLNT	BNVLNT
BERRY	BRY
BRY	BRY
BETTER	BETR
BETR	BETR
BTR	BETR
BEVERAGE	BEV
BEV	BEV
BIBLE	BB
BB	BB
BICYCLE	BIKE
BIKE	BIKE
BIJOU	BIJ
BIJ	BIJ
BIJOUTERIE	BIJTR
BIJTR	BIJTR
BILLETING	BLLTNG
BLLTNG	BLLTNG
BILLIARD	BILLD
BILLD	BILLD
BILLING	BLLNG
BLLNG	BLLNG
BINDER	BDR
BDR	BDR
BINDERY	BDRY
BDRY	BDRY
BINDING	BDNG
BDNG	BDNG
BINGO	BNG
BNG	BNG
BIOCHEMISTRY	BIOCHEM
BIOCHEM	BIOCHEM
BIOLOGICAL	BIOL
BIO	BIOL
BIOL	BIOL
BIOLGCL	BIOL
BIOLOGIST	BIOGST
BIO	BIOGST
BIOGST	BIOGST
BIOL	BIOGST
BIOLOGY	BIO
BIOL	BIO
BIO	BIO
BIOMEDICAL	BIOMDCL
BIOMDCL	BIOMDCL
BIONOMIC	BIONMC
BIONMC	BIONMC
BIOTECHNOLOGY	BIOTECH
BIOTECH	BIOTECH
BISCUIT	BSCT
BSCT	BSCT
BISHOP	BP
BP	BP
BISTRO	BSTR
BSTR	BSTR
BLACK	BLCK
BLCK	BLCK
BLK	BLCK
BLACKSMITH	BSMITH
BSMITH	BSMITH
BLAZON	BLZN
BLZN	BLZN
BLEND	BLEN
BLEN	BLEN
BLESSED	BLSSD
BLSSD	BLSSD
BLIND	BLND
BLND	BLND
BLOCK	BLK
BLK	BLK
BLUEPRINT	BLPRNT
BLPRNT	BLPRNT
BOARD	BD
BD	BD
BRD	BD
BOARDING	BRDNG
BRDNG	BRDNG
BOMBER	BMBR
BMBR	BMBR
BOOKBINDER	BKBNDR
BKBNDR	BKBNDR
BOOKBINDING	BKBNDNG
BKBNDNG	BKBNDNG
BOOKKEEPER	BKPR
BKKP	BKPR
BKKPR	BKPR
BKPR	BKPR
BOOKKEEPING	BKPG
BKKP	BKPG
BKKPG	BKPG
BKKPNG	BKPG
BKPG	BKPG
BOOKKPING	BKPG
BOOKSELLER	BKSLLR
BKSLLR	BKSLLR
BOOKSHELF	BKSHLF
BKSHLF	BKSHLF
BOOKSTORE	BKSTR
BKSTR	BKSTR
BOOKSTOR	BKSTR
BOROUGH	BORO
BORO	BORO
BOTTLED	BOTLD
BOTLD	BOTLD
BOTTLER	BTTLR
BTLR	BTTLR
BTTLR	BTTLR
BOTTLING	BTLG
BOTLNG	BTLG
BTG	BTLG
BTLG	BTLG
BTLNG	BTLG
BOTTOM	BTM
BOT	BTM
BTM	BTM
BOULEVARD	BLVD
BLVD	BLVD
BOUTIQUE	BTQ
BTQ	BTQ
BTQUE	BTQ
BOWLING	BOWL
BOWL	BOWL
BRAIN	BRN
BRN	BRN
BRAKE	BRK
BRK	BRK
BRANCH	BR
BR	BR
BRCH	BR
BRNCH	BR
BRASSERIE	BRSSR
BRSSR	BRSSR
BREEDER	BRDR
BRDR	BRDR
BREWERY	BRWRY
BRWRY	BRWRY
BREWING	BRWNG
BRWNG	BRWNG
BRICK	BRCK
BRCK	BRCK
BRK	BRCK
BRIDAL	BRDL
BRDL	BRDL
BRIDGE	BRG
BDG	BRG
BR	BRG
BRDGE	BRG
BRIEF	BRF
BRF	BRF
BRIGADIER	BRIG
BRIG	BRIG
BRIQUETTE	BRQTT
BRQTT	BRQTT
BRITISH	BRTSH
BRTSH	BRTSH
BROADCAST	BRDCST
BRDCST	BRDCST
BROADCASTER	BRDCSTR
BRDCST	BRDCSTR
BRDCSTR	BRDCSTR
BROADCASTING	BRDCSTG
BROCSTG	BRDCSTG
BROADWAY	BRDWY
BRDWY	BRDWY
BROKER	BRKR
BRK	BRKR
BRKR	BRKR
BROKERAGE	BRKRGE
BRKG	BRKRGE
BRKRGE	BRKRGE
BROTHER	BRO
BRO	BRO
BROTHERHOOD	BRTHD
BRTHD	BRTHD
BROWN	BRWN
BRN	BRWN
BRWN	BRWN
BUCCANEER	BCCNR
BCCNR	BCCNR
BUCKET	BCKT
BCKT	BCKT
BUCKEYE	BCKEYE
BCKEYE	BCKEYE
BUDDY	BDDY
BDDY	BDDY
BUDGET	BGT
BDGT	BGT
BGT	BGT
BUDG	BGT
BUG	BGT
BUGT	BGT
BUFFALO	BUFF
BUILDER	BLDR
BLDR	BLDR
BUILDING	BLDG
BLD	BLDG
BLDG	BLDG
BUILT	BLT
BLT	BLT
BULLDOZING	BLLDZG
BLLDZG	BLLDZG
BULLET	BLLT
BLLT	BLLT
BULLETIN	BLLTN
BLLTN	BLLTN
BUREAU	BUR
BUR	BUR
BURGER	BGR
BGR	BGR
BURNING	BRNNG
BRNNG	BRNNG
BURSAR	BRSR
BRSR	BRSR
BUSINESS	BUS
BSNS	BUS
BUS	BUS
BUSINES	BUS
BUSN	BUS
BUTCHER	BTCHR
BUTLER	BTLR
BTLR	BTLR
BUTLR	BTLR
BUTTER	BUTR
BTR	BUTR
BUTR	BUTR
BUTTON	BUTN
BUTN	BUTN
BUYER	BUYR
BYR	BUYR
BYPASS	BYP
BYP	BYP
CABARET	CBRT
CBRT	CBRT
CABIN	CBN
CBN	CBN
CABINET	CBNT
CAB	CBNT
CBNT	CBNT
CABINETMAKER	CABMKR
CABMKR	CABMKR
CABLE	CABL
CABL	CABL
CBL	CABL
CADET	CDT
CDT	CDT
CADRE	CDR
CDR	CDR
CAFETERIA	CAFTRA
CFTR	CAFTRA
CAFTRA	CAFTRA
CALIPER	CLPR
CLPR	CLPR
CALLIGRAPHER	CLLGRPHR
CLLGRPHR	CLLGRPHR
CALVARY	CLVRY
CALV	CLVRY
CLVRY	CLVRY
CAMERA	CAM
CAM	CAM
CAMPAIGN	CMPGN
CMPGN	CMPGN
CAMPER	CMPR
CMPR	CMPR
CAMPGROUND	CMPGRND
CMPGRND	CMPGRND
CAMPING	CMPNG
CMPNG	CMPNG
CAMPSITE	CMPST
CMPST	CMPST
CAMPUS	CMPS
CMPS	CMPS
CMPUS	CMPS
CANADIAN	CNDN
CNDN	CNDN
CANAL	CNL
CNL	CNL
CANDLELIGHT	CNDLLGHT
CNDLLGHT	CNDLLGHT
CANDY	CNDY
CNDY	CNDY
CANNERY	CAN
CAN	CAN
CANNING	CNNNG
CNNNG	CNNNG
CANTONMENT	CNTNMNT
CNTNMNT	CNTNMNT
CANTOR	CANTR
CANTR	CANTR
CNTR	CANTR
CANVAS	CANV
CANV	CANV
CANYON	CYN
CYN	CYN
CAPITAL	CPTAL
CPTAL	CPTAL
CPTL	CPTAL
CAPITOL	CPTOL
CPTL	CPTOL
CPTOL	CPTOL
CAPTAIN	CAPT
CAPT	CAPT
CPT	CAPT
CARBONATED	CARB
CARB	CARB
CARBURETOR	CARBTR
CARBTR	CARBTR
CARDIAC	CRDC
CRDC	CRDC
CARDINAL	CARD
CARD	CARD
CARDIOGRAPHIC	CRDGRPHC
CRDGRPHC	CRDGRPHC
CARDIOLOGY	CRDLGY
CRDLGY	CRDLGY
CARDIOVASCULAR	CRDVSCLR
CRDVSCLR	CRDVSCLR
CAREER	CAR
CAR	CAR
CARGO	CRG
CRG	CRG
CARIBBEAN	CRBBN
CRBBN	CRBBN
CARLOADING	CRLDNG
CRLDNG	CRLDNG
CARPENTER	CARPTR
CARPTR	CARPTR
CPTR	CARPTR
CARPENTRY	CRPNTRY
CRPNTRY	CRPNTRY
CARPET	CPT
CPT	CPT
CRPT	CPT
CARRIAGE	CARR
CARR	CARR
CGE	CARR
CASCADE	CASC
CASC	CASC
CASHIER	CAS
CAS	CAS
CASH	CAS
CASKET	CSKT
CSKT	CSKT
CASSETTE	CASSTT
CASSTT	CASSTT
CASTING	CAST
CAST	CAST
CASTLE	CASTL
CSTL	CASTL
CASUAL	CSL
CSL	CSL
CASUALTY	CSLTY
CAS	CSLTY
CSLTY	CSLTY
CATALOG	CATLG
CATLG	CATLG
CTLG	CATLG
CATALOGUE	CTLG
CTLG	CTLG
CATERER	CATR
CATR	CATR
CATERING	CTRG
CATRG	CTRG
CTRG	CTRG
CATFISH	CTFSH
CTFSH	CTFSH
CATHEDRAL	CATHDRL
CATH	CATHDRL
CATHDRL	CATHDRL
CATHOLIC	CATH
CATH	CATH
CTHLC	CATH
CATTLE	CTTL
CTTL	CTTL
CAUSEWAY	CSWY
CSWY	CSWY
CEDAR	CEDR
CDR	CEDR
CEDR	CEDR
CELEBRITY	CLBRTY
CLBRTY	CLBRTY
CELLULAR	CELL
CELL	CELL
CEMENT	CEM
CEM	CEM
CEMETERY	CMTRY
CENTENNIAL	CENT
CENT	CENT
CENTENNAL	CENT
CNTNNL	CENT
CENTER	CTR
CEN	CTR
CENT	CTR
CENTR	CTR
CNTR	CTR
CTR	CTR
CENTRAL	CTRL
CENTL	CTRL
CENTR	CTRL
CNTL	CTRL
CNTRL	CTRL
CTRL	CTRL
CENTRE	CTR
CTR	CTR
CENTURY	CEN
CEN	CEN
CERAMIC	CRMC
CRMC	CRMC
CRMIC	CRMC
CEREMONY	CRMNY
CRMNY	CRMNY
CERTIFICATION	CTRFCTN
CTRFCTN	CTRFCTN
CERTIFIED	CERT
CERTD	CERT
CERTIF	CERT
CERTIFIE	CERT
CHAIN	CHN
CH	CHN
CHN	CHN
CHAIR	CHR
CHR	CHR
CHAIRED	CHRD
CHRD	CHRD
CHAIRMAN	CHRMN
CH	CHRMN
CHAIR	CHRMN
CHARMN	CHRMN
CHM	CHRMN
CHMN	CHRMN
CHRM	CHRMN
CHRMN	CHRMN
CHAIRPERSON	CHRPRSN
CHRPRSN	CHRPRSN
CHAIRWOMAN	CHRWMN
CHRWMN	CHRWMN
CHAMBER	CHMBR
CHAMB	CHMBR
CHMBR	CHMBR
CHAMPION	CHAMP
CHAMP	CHAMP
CHANCELLOR	CHANCLLR
CH	CHANCLLR
CHAN	CHANCLLR
CHANCLLR	CHANCLLR
CHANCELOR	CHANCLR
CH	CHANCLR
CHAN	CHANCLR
CHANCLR	CHANCLR
CHANDLER	CHANL
CHANL	CHANL
CHANGE	CHNG
CHNG	CHNG
CHANNEL	CHNNL
CHNNL	CHNNL
CHAPEL	CPL
CPL	CPL
CHAPLAIN	CHAP
CHAP	CHAP
CHAPTER	CHPTR
CHPTR	CHPTR
CHARACTER	CHAR
CHAR	CHAR
CHARCOAL	CHRCL
CHRCL	CHRCL
CHARGE	CHRG
CHARITABLE	CHRTBL
CHRTBL	CHRTBL
CHARTER	CHRTR
CHAR	CHRTR
CHRTR	CHRTR
CHARTERED	CHRTRD
CHRTRD	CHRTRD
CHAUFFEUR	CHFFR
CHFFR	CHFFR
CHAUSSURE	CHSSR
CHSSR	CHSSR
CHECK	CHK
CHK	CHK
CHEESE	CHES
CHES	CHES
CHS	CHES
CHEMICAL	CHEML
CHEM	CHEML
CHEML	CHEML
CHEMIST	CHEM
CHEM	CHEM
CHMST	CHEM
CHERRY	CHRY
CHRY	CHRY
CHESS	CHSS
CHSS	CHSS
CHESTNUT	CHSTNT
CHSTNT	CHSTNT
CHEVROLET	CHEVY
CHEVY	CHEVY
CHICKEN	CHICK
CHC	CHICK
CHCKN	CHICK
CHICK	CHICK
CHKN	CHICK
CHIEF	CHF
CHF	CHF
CHILDREN	CHLD
CHLDRN	CHLD
CHLD	CHLD
CHILDRENS	CHLDS
CHILD	CHLDS
CHIMNEY	CHMNY
CHIM	CHMNY
CHMNY	CHMNY
CHINESE	CHIN
CHIN	CHIN
CHIROPRACTIC	CHIROPRCTC
CHIRO	CHIROPRCTC
CHIROPRAC	CHIROPRCTC
CHIROPRCTC	CHIROPRCTC
CHIROPRACTOR	CHIRO
CHIRO	CHIRO
CHOCOLATE	CHOC
CHOC	CHOC
CHOICE	CHCE
CHCE	CHCE
CHOSE	CHS
CHS	CHS
CHRIST	CHRST
CHR	CHRST
CHRST	CHRST
CHRISTIAN	CHRSTN
CHR	CHRSTN
CHRIST	CHRSTN
CHRISTN	CHRSTN
CHRSTN	CHRSTN
CHRONICLE	CHRNCL
CHRNCL	CHRNCL
CHRYSLER	CHRYSLR
CHRY	CHRYSLR
CHRYSLR	CHRYSLR
CHURCH	CHURCH
CHR	CHURCH
CHUR	CHURCH
CHURC	CHURCH
CIGAR	CG
CG	CG
CIGARETTE	CIG
CIG	CIG
CINEMA	CINE
CINE	CINE
CIRCLE	CIR
CIR	CIR
CRCL	CIR
CIRCUIT	CRCT
CRCT	CRCT
CIRCULAR	CRCLR
CRCLR	CRCLR
CIRCUS	CRCS
CRCS	CRCS
CIRQUE	CRQ
CRQ	CRQ
CITIZEN	CITZN
CITZN	CITZN
CTZN	CITZN
CITRUS	CTRS
CTRS	CTRS
CIVIC	CVC
CVC	CVC
CIVIL	CVL
CVL	CVL
CLAIM	CLM
CLM	CLM
CLASS	CLAS
CLAS	CLAS
CLASSIC	CLSC
CLSC	CLSC
CLASSIFICATION	CLASS
CLASS	CLASS
CLSFCTN	CLASS
CLEAN	CLN
CLN	CLN
CLEANER	CLNR
CLNR	CLNR
CLR	CLNR
CLEANING	CLNG
CLEANG	CLNG
CLG	CLNG
CLNG	CLNG
CLEANSER	CLNSR
CLNSR	CLNSR
CLEARING	CLRNG
CLRNG	CLRNG
CLERGY	CLER
CL	CLER
CLER	CLER
CLERK	CLRK
CK	CLRK
CL	CLRK
CLK	CLRK
CLRK	CLRK
CLIFF	CLFS
CLF	CLFS
CLIMATE	CLIMAT
CLIMAT	CLIMAT
CLINIC	CLNC
CL	CLNC
CLIN	CLNC
CLINI	CLNC
CLNC	CLNC
CLINICAL	CLINIC
CLINIC	CLINIC
CLINICA	CLINIC
CLIPPER	CLPPR
CLPPR	CLPPR
CLOCK	CLCK
CLCK	CLCK
CLK	CLCK
CLOSET	CLOS
CLOS	CLOS
CLOTHES	CLTHS
CLOS	CLTHS
CLTHS	CLTHS
CLOTHIER	CLTHR
CLTHR	CLTHR
CLOTHING	CLTHNG
CL	CLTHNG
CLTHNG	CLTHNG
CLUBHOUSE	CLBHS
CLBHS	CLBHS
CLUTCH	CLTCH
CLTCH	CLTCH
COACH	CH
CCH	CH
COAST	CST
CST	CST
COASTAL	CSTL
CSTL	CSTL
COATED	CTD
CTD	CTD
COATING	CTNG
CTNG	CTNG
COCKPIT	CCKPT
CCKPT	CCKPT
COCOA	CCO
CCO	CCO
COFFEE	COF
COF	COF
COIFFEUR	CFFR
CFFR	CFFR
COIFFEUSE	CFFS
CFFS	CFFS
COIFFURE	COIFF
COIFF	COIFF
COLLABORATIVE	CLLBRTV
CLLBRTV	CLLBRTV
COLL	CLLBRTV
COLLATERAL	CLLTRL
CLLTRL	CLLTRL
COLLECTABLE	CLLCTABL
CLLCTABL	CLLCTABL
CLLCTBL	CLLCTABL
COLLECTIBLE	CLLCTIBL
CLLCTBL	CLLCTIBL
CLLCTIBL	CLLCTIBL
COLLECTION	COLLECT
CLCTN	COLLECT
COLLECT	COLLECT
COLLECTN	COLLECT
COLLECTIVE	CLLCTV
CLLCTV	CLLCTV
COLLECT0R	COLL
COLL	COLL
COLLEGE	COLG
CLG	COLG
CLGE	COLG
COLG	COLG
COL	COLG
COLL	COLG
COLLEG	COLG
COLLEGIATE	COLGT
COLGT	COLGT
COLLISION	CLLSN
CLLSN	CLLSN
COLONEL	COL
COL	COL
COLONIAL	CLNL
CLNL	CLNL
COL	CLNL
COLONY	CLNY
CLNY	CLNY
COLOR	CLR
CLR	CLR
COLOSSAL	CLSSL
CLSSL	CLSSL
COMBINED	COMB
COM	COMB
COMB	COMB
COMBUSTION	COMBSTN
CMBSTN	COMBSTN
COMBSTN	COMBSTN
COMFORT	CMFRT
CMFRT	CMFRT
CMFT	CMFRT
COMMAND	CMND
CMND	CMND
COM	CMND
COMMANDANT	COMDT
COM	COMDT
COMDT	COMDT
COMMDT	COMDT
COMMANDER	CMDR
CDR	CMDR
CMDR	CMDR
COM	CMDR
COMM	CMDR
COMMDR	CMDR
COMMANDING	COMDG
COMDG	COMDG
COMMENCEMENT	COMMNCMNT
COMMNCMNT	COMMNCMNT
COMMERCE	COMMRCE
CMMRC	COMMRCE
COMM	COMMRCE
COMMERC	COMMRCE
COMMRCE	COMMRCE
COMMERCIAL	COMRCL
CMRCL	COMRCL
COMRCL	COMRCL
COMMISSARY	COMSY
COMSY	COMSY
COMMISSION	COMM
COMM	COMM
COMMISSIONER	COMMR
COMMR	COMMR
COMMITTEE	CMMTE
CMMTE	CMMTE
COM	CMMTE
COMITE	CMMTE
COMM	CMMTE
COMMODITY	COM
COM	COM
COMMODORE	COMD
COMD	COMD
COMO	COMD
COMMON	CMMN
CMMN	CMMN
COMMONWEALTH	CMNWLTH
CMNWLTH	CMNWLTH
COMMONWLTH	CMNWLTH
COMMUNE	COMMN
COMMN	COMMN
COMMUNICATE	COMMUN
COMM	COMMUN
CCOMMNCTE	COMMUN
COMMUNICAT	COMMUN
COMMUNICATION	COMMCTN
COMM	COMMCTN
COMMCTN	COMMCTN
COMMUN	COMMCTN
COMMUNICATI	COMMCTN
COMMUNICTN	COMMCTN
COMMUNIQUE	COMMNQ
COMMNQ	COMMNQ
COMMUNITY	CMNTY
CMMNTY	CMNTY
CMNTY	CMNTY
CMTY	CMNTY
COM	CMNTY
COMM	CMNTY
COMNTY	CMNTY
CTY	CMNTY
COMPANY	CO
CO	CO
COMP	CO
COMPAN	CO
COMPNY	CO
COMPARATIVE	COMPRTV
COMPRTV	COMPRTV
COMPATIBLE	COMPTBL
COMPTBL	COMPTBL
COMPENSATION	CMPNSTN
CMPNSTN	CMPNSTN
COMPILER	COMPLR
COMP	COMPLR
COMPLR	COMPLR
COMPLETE	CMPLT
CMPLT	CMPLT
COMPLET	CMPLT
COMPLEX	COMPLX
COMPLX	COMPLX
COMPONENT	COMPNNT
COMPNNT	COMPNNT
COMPOSE	COMPS
COMPS	COMPS
COMPOSITE	COMPST
COMPST	COMPST
COMPOSITION	COMP
COMP	COMP
COMPOUNDING	COMPNDNG
COMPNDNG	COMPNDNG
COMPREHENSIVE	CMPRHNSV
CMPRHNSV	CMPRHNSV
COMPRESS	COMPRSS
COMPRSS	COMPRSS
COMPRESSOR	CMPSR
CMPSR	CMPSR
COMPTABLE	COMPTBLE
COMPTBLE	COMPTBLE
COMPTROLLER	COMPTLR
CMPTRLR	COMPTLR
COMP	COMPTLR
COMPT	COMPTLR
COMPTLR	COMPTLR
COMPTLR	COMPTLR
COMPTRLR	COMPTLR
COMPTROLL	COMPTLR
COMPUTER	CMPTR
CMP	CMPTR
CMPTR	CMPTR
COM	CMPTR
COMP	CMPTR
COMPTR	CMPTR
COMPU	CMPTR
COMPUTERIZED	COMPTRZD
COMPTRZD	COMPTRZD
COMPUTING	CMPTG
CMPTG	CMPTG
CONCENTRATE	CONCNTRT
CON	CONCNTRT
CONCNTRT	CONCNTRT
CONCEPT	CNCPT
CNCPT	CNCPT
CONCESSION	CONCSSN
CONCSSN	CONCSSN
CONCOURSE	CONCRS
CONCRS	CONCRS
CONCRETE	CONCRT
CON	CONCRT
CONCRET	CONCRT
CONCRT	CONCRT
CONDITIONING	COND
CNDNTNG	COND
COND	COND
CONDOMINIUM	CONDO
CNDMNM	CONDO
CONDO	CONDO
CONFECTIONERY	CONF
CONF	CONF
CONFEDERATED	CONFDRTD
CONFDRTD	CONFDRTD
CONFEDERATION	CONFDRTN
CONFDRTN	CONFDRTN
CONFER	CNFR
CNFR	CNFR
CONFERENCE	CNFRNC
CNFRNC	CNFRNC
CONFRENCE	CNFRNC
CONGREGATION	CONGREG
CONGREG	CONGREG
CONGRG	CONGREG
CONGREGATIONAL	CONGREGTNL
CONGREGTNL	CONGREGTNL
CONGRESS	CNGRS
CNGRS	CNGRS
CONGRESSIONAL	CNGRSNL
CNGRSNL	CNGRSNL
CONGRESSMAN	CONGRSMAN
CONGRSMAN	CONGRSMAN
CONNECTION	CONNECT
CONNECT	CONNECT
CONQUISTADOR	CONQUISDR
CONQUISDR	CONQUISDR
CONSERVATION	CONSERVE
CNSRVTN	CONSERVE
CNSVTN	CONSERVE
CONSER	CONSERVE
CONSERV	CONSERVE
CONSERVE	CONSERVE
CONSERVATORY	CONSRVTRY
CONSRVTRY	CONSRVTRY
CONSOLATION	CONSLTN
CONSLTN	CONSLTN
CONSOLIDATED	CONS
CNSLD	CONS
CNSLDTD	CONS
CONS	CONS
CONSOLIDATION	CONSLDTN
CONSLDTN	CONSLDTN
CONSOLIDATOR	CONSLDTR
CONSLDTR	CONSLDTR
CONSORTIUM	CNSRTM
CNSRTM	CNSRTM
CONSTRUCT	CONSTRCT
CONSTRCT	CONSTRCT
CONSTRUCTING	CNSTRCTNG
CNSTRCTNG	CNSTRCTNG
CONSTG	CNSTRCTNG
CONSTRUCTION	CONSTRCTN
CNST	CONSTRCTN
CNSTR	CONSTRCTN
CNSTCONSTRCTN	CONSTRCTN
CONSTN	CONSTRCTN
CONSTR	CONSTRCTN
CONSTRCTN	CONSTRCTN
CONSTRN	CONSTRCTN
CONSTRTN	CONSTRCTN
CONSTRUCTN	CONSTRCTN
CONSTRUCTOR	CONSTR
CNSTR	CONSTR
CONSTR	CONSTR
CONSULT	CON
CON	CON
CONSULTANT	CONSLNT
CNSLT	CONSLNT
CNSLTNT	CONSLNT
CON	CONSLNT
CONS	CONSLNT
CONSL	CONSLNT
CONSLTNT	CONSLNT
CONSULT	CONSLNT
CONSULTA	CONSLNT
CONSULTAN	CONSLNT
CONSULTNT	CONSLNT
CONSULTATION	CNSLTN
CNSLTN	CNSLTN
CONSULTING	CONSLTNG
CNSLTNG	CONSLTNG
CONSLNTNG	CONSLTNG
CONSLTG	CONSLTNG
CONSLTNG	CONSLTNG
CONSULTI	CONSLTNG
CONSULTIN	CONSLTNG
CONSUMER	CONSMR
CNSMR	CONSMR
CONS	CONSMR
CONSMR	CONSMR
CONTACT	CONT
CONT	CONT
CONTAIN	CNTN
CNTN	CNTN
CONTAINER	CONTNR
CONTNR	CONTNR
CONTEMPORARY	CONTEMP
CONTEMP	CONTEMP
CONTEMPO	CONTEMP
CONTEMPOR	CONTEMP
CONTEMPORAR	CONTEMP
CONTEST	CNTST
CNTST	CNTST
CONTINENTAL	CONTNTL
CNTNTL	CONTNTL
CONT	CONTNTL
CONTINENT	CONTNTL
CONTNENTA	CONTNTL
CONTINENTL	CONTNTL
CONTNTL	CONTNTL
CONTINUING	CONTNG
CONTNG	CONTNG
CONTINUOUS	CONTNS
CONTNS	CONTNS
CONTRACT	CNTRCT
CNTR	CNTRCT
CNTRCT	CNTRCT
CONTR	CNTRCT
CONTRAC	CNTRCT
CONTRACTING	CNTRCTNG
CNTRCTNG	CNTRCTNG
CONTG	CNTRCTNG
CONTR	CNTRCTNG
CONTRACTIN	CNTRCTNG
CONTRG	CNTRCTNG
CONTRACTOR	CONTR
CNTRCTR	CONTR
CONTR	CONTR
COR	CONTR
CONTRIBUTION	CONTRBTN
CONTRBTN	CONTRBTN
CONTROL	CNTRL
CNTRL	CNTRL
CONTRL	CNTRL
CTL	CNTRL
CTRL	CNTRL
CONTROLLED	CONTRLLD
CONTRLLD	CONTRLLD
CONTROLLER	CNTRLLR
CNTLR	CNTRLLR
CNTR	CNTRLLR
CNTRL	CNTRLLR
CNTRLLR	CNTRLLR
CNTRLR	CNTRLLR
CONTLR	CNTRLLR
CONTR	CNTRLLR
CONTRLLR	CNTRLLR
CONTRLR	CNTRLLR
CONTROLER	CNTRLLR
CONTROLL	CNTRLLR
CONTROLLE	CNTRLLR
CONTROLLR	CNTRLLR
CTL	CNTRLLR
CTLR	CNTRLLR
CTRLR	CNTRLLR
CONVALESCENT	CONVAL
CONV	CONVAL
CONVALESCEN	CONVAL
CONVENIENCE	CONV
CONV	CONV
CONVENIENT	CONVNT
CONVNT	CONVNT
CONVENT	CNVNT
CNVNT	CNVNT
CONVNT	CNVNT
CONVENTION	CNVNTN
CNVNTN	CNVNTN
CONVERSE	CONVRS
CONVRS	CONVRS
CONVERSION	CNVRSN
CNVRSN	CNVRSN
CONVERTER	CONVRTR
CONVRTR	CONVRTR
CONVERTIBLE	CONVRTBL
CONVRTBL	CONVRTBL
CONVEYOR	CONVYR
CONVYR	CONVYR
COOKED	CKD
CKD	CKD
COOKIE	CK
CK	CK
COOLING	COOL
COOL	COOL
COOLG	COOL
COOPERATE	COOP
COOP	COOP
COOPERATIVE	COOPRTV
CO OP	COOPRTV
COOP	COOPRTV
COOPRTV	COOPRTV
COORDINANT	COORD
COORD	COORD
COORDINATE	COORDNT
COORDNT	COORDNT
COORDINATOR	COORDNTR
COOR	COORDNTR
COORD	COORDNTR
COORDNTR	COORDNTR
COPIER	COPR
COPR	COPR
COPPER	COP
COP	COP
CORNER	CORN
COR	CORN
CORNR	CORN
CORONER	COR
COR	COR
CORPORAL	CORPL
CORP	CORPL
CORPL	CORPL
CPL	CORPL
CORPORATE	CORPRT
CORP	CORPRT
CORPORT	CORPRT
CORPRT	CORPRT
CRP	CORPRT
CORPORATION	CORP
CORP	CORP
CORPORATIN	CORP
CORPORATIO	CORP
CORRECT	CRRCT
CRRCT	CRRCT
CORRECTION	CRRCTN
CRRCTN	CRRCTN
CORRECTIONAL	CRRCTNL
CORCTNL	CRRCTNL
CRRCTNL	CRRCTNL
CORRESPONDENCE	CORR
CORR	CORR
CORRESPONDENT	CORRSPNDNT
COR	CORRSPNDNT
CORR	CORRSPNDNT
CORRSPNDNT	CORRSPNDNT
CORRUGATED	CORRGTD
CORRGTD	CORRGTD
COSMETIC	CSMTC
COSMT	CSMTC
CSMTC	CSMTC
COSMETOLOGIST	CSMTLGST
COS	CSMTLGST
CSMTLGST	CSMTLGST
COTTAGE	CTG
CTG	CTG
COTTON	COT
COT	COT
COUNCIL	CNCL
CL	CNCL
CNCL	CNCL
COUNCI	CNCL
COUNCILING	CNCLNG
CNCLNG	CNCLNG
COUNSEL	CNSL
CNSL	CNSL
COL	CNSL
COUNSELING	CNSLNG
CNSLNG	CNSLNG
COUNSELLOR	CNSLLR
CNSLLR	CNSLLR
CNSLR	CNSLLR
COUNSELOR	CNSLR
CNSLR	CNSLR
COUNT	CNT
CNT	CNT
COUNTER	CNTR
CNTR	CNTR
COUNTRY	CNTRY
CNTRY	CNTRY
CO	CNTRY
CTRY	CNTRY
COUNTRYSIDE	CNTRYSD
CNTRYSD	CNTRYSD
COUNTY	CNTY
CNTY	CNTY
CO	CNTY
CTY	CNTY
COUPE	CP
CP	CP
COURIER	COUR
COUR	COUR
COURIR	COUR
COURSE	CRS
CRS	CRS
CRSE	CRS
COURT	CT
CRT	CT
CT	CT
COURTESY	CRTSY
CRTSY	CRTSY
COVENANT	CVNNT
CVNNT	CVNNT
COVERING	COVER
COVER	COVER
CVG	COVER
CVRNG	COVER
COWBOY	CWBY
CWBY	CWBY
CRAFT	CRFT
CFT	CRFT
CRFT	CRFT
CRAFTER	CFTR
CFTR	CFTR
CRAFTSMAN	CFT
CFT	CFT
CRAFTSMEN	CFTMN
CFTMN	CFTMN
CRANBERRY	CRNBRRY
CRNBRRY	CRNBRRY
CRANE	CRN
CRN	CRN
CRANKSHAFT	CRNKSHFT
CRNKSHFT	CRNKSHFT
CRAZY	CRZY
CRZY	CRZY
CREAM	CRM
CRM	CRM
CREAMERY	CRMRY
CRMRY	CRMRY
CREATION	CREAT
CREAT	CREAT
CREATIVE	CREATV
CREAT	CREATV
CREATV	CREATV
CRTVE	CREATV
CREDIT	CRDT
CRDT	CRDT
CRED	CRDT
CREEK	CRK
CRK	CRK
CREMATORY	CRMTRY
CRMTRY	CRMTRY
CREPE	CRP
CRP	CRP
CRESCENT	CRES
CRES	CRES
CREST	CREST
CRST	CREST
CRIMINAL	CRMNL
CRMNL	CRMNL
CROCKERY	CKRY
CKRY	CKRY
CRK	CKRY
CROSS	CR
CR	CR
CROSSING	XING
CRSSNG	XING
CROSSROAD	XROAD
CROSSRD	XROAD
XRD	XROAD
XROAD	XROAD
CROWN	CRWN
CRN	CRWN
CRWN	CRWN
CRUISE	CRUS
CRS	CRUS
CRUS	CRUS
CRUSADE	CRSD
CRSD	CRSD
CRUSADER	CRSDR
CRSDR	CRSDR
CRUST	CRUST
CRST	CRUST
CRYOGENIC	CRYGNC
CRYGNC	CRYGNC
CRYSTAL	CRYSTL
CRYSTL	CRYSTL
CUISINE	CSN
CSN	CSN
CULTURAL	CLTRL
CLTRL	CLTRL
CUPBOARD	CPBRD
CPBRD	CPBRD
CURATOR	CUR
CUR	CUR
CURRICULUM	CURR
CURR	CURR
CURTAIN	CRTN
CRTN	CRTN
CUSTODIAN	CUSTDN
CUST	CUSTDN
CUSTDN	CUSTDN
CUSTOM	CSTM
CSTM	CSTM
CUST	CSTM
CUSTOMER	CUST
CUST	CUST
CUTLERY	CUTLY
CUTLY	CUTLY
CUTTING	CUT
CUT	CUT
CUTING	CUT
CYBERNETIC	CYBRNTC
CYBRNTC	CYBRNTC
CYCLE	CYCL
CYCL	CYCL
DAILY	DLY
DLY	DLY
DAIRY	DRY
DAR	DRY
DRY	DRY
DAME	DM
DM	DM
DANCE	DNC
DNC	DNC
DATABASE	DB
DB	DB
DATZUN	DTZN
DTZN	DTZN
DAUGHTER	DGHTR
DGHTR	DGHTR
DEACON	DCN
DCN	DCN
DEALER	DLR
DLR	DLR
DEALING	DLG
DLG	DLG
DECAL	DEC
DEC	DEC
DECISION	DCSN
DCSN	DCSN
DECOR	DCR
DCR	DCR
DECORATING	DECOR
DCRTNG	DECOR
DCTG	DECOR
DECOR	DECOR
DECORATION	DCTN
DCTN	DCTN
DECORATOR	DCRTR
DCRTR	DCRTR
DCTR	DCRTR
DEFENCE	DEFNC
DEF	DEFNC
DEFNC	DEFNC
DEFENSE	DEFNS
DEFNS	DEFNS
DELICATESSEN	DELI
DELI	DELI
DELIGHT	DLGHT
DLGHT	DLGHT
DELINTING	DLNTG
DLNTG	DLNTG
DELIVERANCE	DELVRNC
DELIVRANCE	DELVRNC
DELVRNC	DELVRNC
DELIVERY	DLVRY
DEL	DLVRY
DLVRY	DLVRY
DELTA	DLT
DLT	DLT
DEMOCRATIC	DEM
DEM	DEM
DEMOLITION	DEMLTN
DEM	DEMLTN
DEMLTN	DEMLTN
DENTAL	DNTL
DNTL	DNTL
DENTIST	DDS
DENT	DDS
DDS	DDS
DENTISTRY	DNTSTRY
DNTSTRY	DNTSTRY
DENTURE	DENTR
DENTR	DENTR
DNTR	DENTR
DEPARTMENT	DEPT
DEP	DEPT
DEPART	DEPT
DEPARTM	DEPT
DEPARTMNT	DEPT
DEPT	DEPT
DPT	DEPT
DEPENDABLE	DPNDBL
DPNDBL	DPNDBL
DEPOSIT	DPST
DPST	DPST
DEPOT	DEP
DEP	DEP
DPT	DEP
DEPUTY	DPTY
DEP	DPTY
DEPT	DPTY
DPTY	DPTY
DERMATOLOGIST	DERMTLGST
DERM	DERMTLGST
DERMTLGST	DERMTLGST
DERMATOLOGY	DERM
DERM	DERM
DESERT	DSRT
DSRT	DSRT
DESIGN	DSGN
DES	DSGN
DSGN	DSGN
DESIGNER	DSGNR
DESGR	DSGNR
DSGNR	DSGNR
DSGR	DSGNR
DESIGNING	DSGNG
DSGNG	DSGNG
DETAIL	DTL
DTL	DTL
DETECTIVE	DET
DET	DET
DETENTION	DETNTN
DEVELOPER	DVLPR
DVLPR	DVLPR
DEVELOPMENT	DEV
DEV	DEV
DEVEL	DEV
DEVELOP	DEV
DEVELOPM	DEV
DEVELOPMEN	DEV
DEVELOPMNT	DEV
DEVELOPMT	DEV
DEVELP	DEV
DEVELPMT	DEV
DEVLMNT	DEV
DEVLPMNT	DEV
DEVLPMT	DEV
DEVMT	DEV
DVLOPMT	DEV
DVLPMNT	DEV
DVLPMT	DEV
DEVELOPMENTAL	DEVLPMNTL
DEVLPMNTL	DEVLPMNTL
DEVICE	DVC
DVC	DVC
DIAGNOSTIC	DGNSTC
DGNSTC	DGNSTC
DIAG	DGNSTC
DIAMOND	DMND
DMND	DMND
DIAPER	DPR
DPR	DPR
DICTATOR	DICT
DICT	DICT
DIELECTRIC	DLCTRC
DLCTRC	DLCTRC
DIESEL	DSL
DSL	DSL
DIETARY	DTRY
DIETRY	DTRY
DTRY	DTRY
DIETETIC	DIETC
DIETC	DIETC
DIETEIC	DIETC
DIFFERENT	DIFF
DIFF	DIFF
DIFFUSION	DIFFSN
DIFF	DIFFSN
DIFFSN	DIFFSN
DIGEST	DGST
DGST	DGST
DIGESTIVE	DGSTV
DGSTV	DGSTV
DIGITAL	DGTL
DGTL	DGTL
DILIGENCE	DLGNC
DLGNC	DLGNC
DIMENSION	DIM
DIM	DIM
DIMENSIONAL	DIML
DIML	DIML
DINER	DNR
DIN	DNR
DNR	DNR
DIOCESE	DIO
DIO	DIO
DIODE	DIOD
DIOD	DIOD
DIRECT	DIRECT
DIR	DIRECT
DIRECTION	DIRCTN
DIRCTN	DIRCTN
DIRECTIONAL	DIRCTNL
DIRCTNL	DIRCTNL
DIRECTOR	DIR
DIR	DIR
DIRCTR	DIR
DIRECTORATE	DIRCTRT
DIRCTRT	DIRCTRT
DIRECTORY	DIRCTRY
DISABILITY	DSBLTY
DSBLTY	DSBLTY
DISARMAMENT	DSARMNT
DSARMNT	DSARMNT
DISBURSEMENT	DISBMT
DISBMT	DISBMT
DISCOUNT	DISC
DISC	DISC
DISPATCH	DISP
DISP	DISP
DISPTCH	DISP
DISPATCHER	DISPR
DISP	DISPR
DISPR	DISPR
DISPENSARY	DSPN
DSPN	DSPN
DISPLAY	DSPLY
DISP	DSPLY
DSPLY	DSPLY
DISPOSAL	DSPSL
DSPSL	DSPSL
DISTILLER	DISTLR
DIST	DISTLR
DISTLR	DISTLR
DISTILLERY	DISTLLRY
DIST	DISTLLRY
DISTLLRY	DISTLLRY
DISTINCTIVE	DISTNCTV
DISTNCTV	DISTNCTV
DISTRIBUTING	DISTRG
DISTR	DISTRG
DISTRG	DISTRG
DISTRIB	DISTRG
DISTRIBUTIN	DISTRG
DISTRIBUTION	DISTRB
DIST	DISTRB
DISTR	DISTRB
DISTRB	DISTRB
DISTRIB	DISTRB
DISTRIBUTIN	DISTRB
DSTRBTN	DISTRB
DISTRIBUTOR	DISTR
DISTR	DISTR
DISTRIB	DISTR
DISTRIBTR	DISTR
DISTRIBUT	DISTR
DSTBTR	DISTR
DISTRICT	DIST
DIST	DIST
DST	DIST
DIVERSIFIED	DVSFD
DVRSFD	DVSFD
DVSFD	DVSFD
DIVIDE	DV
DIV	DV
DIVING	DVNG
DVNG	DVNG
DIVISION	DIV
DIV	DIV
DIVSN	DIV
DIVISIONAL	DIVSNL
DIV	DIVSNL
DIVSNL	DIVSNL
DVSNL	DIVSNL
DOCTOR	DR
DO	DR
DR	DR
M D	DR
MD	DR
PH D	DR
DOCTRINE	DOCTRN
DOCTRN	DOCTRN
DOCUMENTATION	DCMNTN
DCMNTN	DCMNTN
DODGE	DDG
DDG	DDG
DOLLAR	DLLR
DLLR	DLLR
DLR	DLLR
DOMESTIC	DOM
DOM	DOM
DOMINION	DOMNN
DOMNN	DOMNN
DONNEE	DNN
DNN	DNN
DOUBLE	DBL
DBL	DBL
DOUGHNUT	DONUT
DNT	DONUT
DONUT	DONUT
DOWNTOWN	DWNTN
DWNTN	DWNTN
DRAFTING	DRFTNG
DRFTNG	DRFTNG
DRAFTSMAN	DFTSMAN
DFTSMAN	DFTSMAN
DRAFTS	DFTSMAN
DRAGON	DRGN
DRGN	DRGN
DRAIN	DRN
DRN	DRN
DRAINAGE	DRNG
DRNG	DRNG
DRAMA	DRMA
DRMA	DRMA
DRAPERY	DRAP
DRAP	DRAP
DRAPERIES	DRAP
DREAM	DRM
DRM	DRM
DRESS	DRS
DRS	DRS
DRILL	DRLL
DRLL	DRLL
DRILLING	DRILL
DRILL	DRILL
DRLG	DRILL
DRIVING	DRG
DRVG	DRG
DRYWALL	DRYWL
DRYWL	DRYWL
DUCHESS	DCHSS
DCHSS	DCHSS
DUPLICATING	DUPNG
DUP	DUPNG
DUPNG	DUPNG
DUPLICATION	DUP
DUP	DUP
DUTCH	DTCH
DTCH	DTCH
DWELLING	DWLLNG
DWLLNG	DWLLNG
DYEING	DYNG
DYG	DYNG
DYNG	DYNG
DYING	DYG
DYG	DYG
DYNAMIC	DYNMC
DYNA	DYNMC
DYNMC	DYNMC
EAGLE	EGL
EGL	EGL
EARLY	ERLY
ERLY	ERLY
EARTH	ERTH
ERTH	ERTH
EASTERN	ESTRN
ESTRN	ESTRN
EASTSIDE	ESTSD
ESTSD	ESTSD
EATERY	ETRY
ETRY	ETRY
ECOLOGY	ECO
ECLGY	ECO
ECO	ECO
ECOLO	ECO
ECONOMIC	ECNMC
ECNMC	ECNMC
ECON	ECNMC
ECONOMIST	ECONMST
ECOM	ECONMST
ECON	ECONMST
ECONMST	ECONMST
ECONOMY	ECON
ECON	ECON
EDIBLE	EDBL
EDBL	EDBL
EDIFICE	EDFC
EDFC	EDFC
EDITION	ED
ED	ED
EDITOR	EDIT
EDIT	EDIT
EDTR	EDIT
EDUCATION	EDUC
ED	EDUC
EDCT	EDUC
EDCTN	EDUC
EDUC	EDUC
EDUCATIONAL	EDUCL
EDUC	EDUCL
EDUCATIONL	EDUCL
EDUCL	EDUCL
EDUCTL	EDUCL
EIGHTH	8TH
VIII	8TH
8TH	8TH
ELDER	ELDR
ELDR	ELDR
ELDERLY	ELDRLY
ELDRLY	ELDRLY
ELECT	ELEC
ELCT	ELEC
ELE	ELEC
ELEC	ELEC
ELECTED	ELCTD
ELCTD	ELCTD
ELECT	ELCTD
ELECTRIC	ELECTR
ELC	ELECTR
ELEC	ELECTR
ELECT	ELECTR
ELECTR	ELECTR
ELECTRICAL	ELECTRL
ELEC	ELECTRL
ELECT	ELECTRL
ELECTRL	ELECTRL
ELECTRICIAN	ELECTRCN
ELEC	ELECTRCN
ELECT	ELECTRCN
ELECTRCN	ELECTRCN
ELECTRICITY	ELECTRCTY
ELEC	ELECTRCTY
ELECT	ELECTRCTY
ELECTRCTY	ELECTRCTY
ELECTROLOGIST	ELCTRLGST
ELCTRLGST	ELCTRLGST
ELECTROLYSIS	ELCTRLYS
ELCTRLYS	ELCTRLYS
ELECTRLSIS	ELCTRLYS
ELECTRLYS	ELCTRLYS
ELECTROMECHANICAL	ELCTRMCHNCL
ELCTRMCHNCL	ELCTRMCHNCL
ELECTROMEDICAL	ELCMED
ELCMED	ELCMED
ELECTROMETALLURGICAL	ELCMTLG
ELCMTLG	ELCMTLG
ELECTRON	ELCTRN
ELCTRN	ELCTRN
ELECTRONIC	ELECT
ELEC	ELECT
ELECT	ELECT
ELECTRNC	ELECT
ELECTROPLATING	ELCPLTG
ELCPLTG	ELCPLTG
ELEGANCE	ELGNC
ELGNC	ELGNC
ELEGANT	ELGNT
ELGNT	ELGNT
ELEMENT	ELMNT
ELMNT	ELMNT
ELEMENTARY	ELEM
ELEM	ELEM
ELEVATOR	ELEV
ELEV	ELEV
ELEVENTH	11TH
XI	11TH
11	11TH
11TH	11TH
ELITE	ELITE
EMBASSY	EMBSSY
EMBSSY	EMBSSY
EMBROIDERY	EMB
EMB	EMB
EMERGENCY	EMER
EMER	EMER
EMERG	EMER
EMERGNCY	EMER
EMPIRE	EMP
EMP	EMP
EMPLOYED	EMPL
EMPL	EMPL
EMPLOY	EMPL
EMPLOYEE	EMPLYE
EMPL	EMPLYE
EMPLYE	EMPLYE
EMPLOYMENT	EMPLMNT
EMPL	EMPLMNT
EMPLMNT	EMPLMNT
EMPLMT	EMPLMNT
EMPORIUM	EMPOR
EMPOR	EMPOR
EMPORM	EMPOR
EMPRM	EMPOR
ENAMEL	ENL
ENL	ENL
ENAMELING	ENMLNG
ENMLNG	ENMLNG
ENCYCLOPEDIA	ENCY
ENCY	ENCY
ENDEAVOR	ENDVR
ENDVR	ENDVR
ENDOCRINOLOGIST	ENDCRNLGST
ENDCRNLGST	ENDCRNLGST
ENDODONTIC	ENDDNTC
ENDDNTC	ENDDNTC
ENERGY	ENGRY
ENGRY	ENGRY
ENGY	ENGRY
ENRG	ENGRY
ENGRY	ENGRY
ENFORCEMENT	ENFCMNT
ENFCMNT	ENFCMNT
ENGINE	ENG
ENG	ENG
ENGINEER	ENGR
ENG	ENGR
ENGR	ENGR
ENGINEERED	ENGRD
ENGRD	ENGRD
ENGINEERING	ENGRG
ENG	ENGRG
ENGINRNG	ENGRG
ENGR	ENGRG
ENGRG	ENGRG
ENGRNG	ENGRG
ENGLAND	ENGLD
ENG	ENGLD
ENGL	ENGLD
ENGLD	ENGLD
ENGLISH	ENGL
ENGL	ENGL
ENGLSH	ENGL
ENGRAVER	ENGRVR
ENGRVR	ENGRVR
ENGRAVING	ENGRV
ENGRV	ENGRV
ENLARGE	ENLRG
ENLRG	ENLRG
ENSIGN	ENS
ENS	ENS
ENTERPRISE	ENTRPRS
ENT	ENTRPRS
ENTER	ENTRPRS
ENTERP	ENTRPRS
ENTERPRS	ENTRPRS
ENTP	ENTRPRS
ENTPR	ENTRPRS
ENTPS	ENTRPRS
ENTRPR	ENTRPRS
ENTRPRS	ENTRPRS
ENTERTAINMENT	ENTRTN
ENTRMT	ENTRTN
ENTRTN	ENTRTN
ENTREPOT	ENTRPT
ENTRPT	ENTRPT
ENTREPENEUR	ENTRPRNR
ENTRPRNR	ENTRPRNR
ENTRY	ENT
ENT	ENT
ENVELOPE	ENV
ENV	ENV
ENVIRONMENT	ENVIR
ENVIR	ENVIR
ENVIRON	ENVIR
ENVRMT	ENVIR
ENVRONMEN	ENVIR
ENVIRONMENTAL	ENVIRON
ENVIRON	ENVIRON
ENVRMTL	ENVIRON
ENVRNMTL	ENVIRON
EPISCOPAL	EPISCPL
EPIS	EPISCPL
EPISCPL	EPISCPL
EPSCP	EPISCPL
EPSCPL	EPISCPL
EPSILON	EPSLN
EPSLN	EPSLN
EQUAL	EQL
EQL	EQL
EQUESTRIAN	EQSTRN
EQSTRN	EQSTRN
EQUINE	EQN
EQN	EQN
EQUIPMENT	EQUIP
EQIPMENT	EQUIP
EQP	EQUIP
EQPMNT	EQUIP
EQPT	EQUIP
EQUIP	EQUIP
EQUIPT	EQUIP
EQUITABLE	EQTBL
EQTBL	EQTBL
EQUITY	EQTY
EQTY	EQTY
EQUTY	EQTY
ERECTING	ERCT
ERCT	ERCT
ERECTOR	ERCTR
ERCTR	ERCTR
ESQUIRE	ESQ
ESQ	ESQ
ESSENTIAL	ESSNTL
ESSTNL	ESSNTL
ESTABLISHMENT	ESTAB
EST	ESTAB
ESTAB	ESTAB
ESTATE	EST
EST	EST
ESTIMATION	ESTMTN
ESTMTN	ESTMTN
ESTIMATOR	ESTMTR
EST	ESTMTR
ESTMTR	ESTMTR
ETCETERA	ETC
ETC	ETC
ETUDE	ETD
ETD	ETD
EUROPEAN	ERPN
ERPN	ERPN
EVALUATION	EVAL
EV	EVAL
EVAL	EVAL
EVANGELICAL	EVNGLCL
EVNGLCL	EVNGLCL
EVANGELIST	EVNGLST
EVNGLST	EVNGLST
EVANGELISTIC	EVNGLSTC
EVNGLSTC	EVNGLSTC
EVENING	EVNNG
EVNNG	EVNNG
EVENT	EVNT
EVNT	EVNT
EVERGREEN	EVRGRN
EVRGRN	EVRGRN
EXACT	EXCT
EXCT	EXCT
EXAMINATION	EXMNTN
EXMNTN	EXMNTN
EXAMINE	EXAM
EX	EXAM
EXAM	EXAM
EXMN	EXAM
EXAMINER	EXMNR
EXMNR	EXMNR
EXCAVATE	EXCVT
EXCVT	EXCVT
EXCAVATING	EXCAVTG
EXCAVATNG	EXCAVTG
EXCAVTG	EXCAVTG
EXCVTG	EXCAVTG
EXCAVATION	EXCVTN
EXCTVN	EXCVTN
EXCAVATOR	EXCVTR
EXCAVATR	EXCVTR
EXCVTR	EXCVTR
EXCEL	EXCL
EXCL	EXCL
EXCELSIOR	EXCLSR
EXCEL	EXCLSR
EXCLSR	EXCLSR
EXCEPTIONAL	EXCPTNL
EXCPTNL	EXCPTNL
EXCESS	EXCSS
EXCSS	EXCSS
EXCHANGE	EXCH
ECHANGE	EXCH
EXCH	EXCH
EXECUTIVE	EXEC
EX	EXEC
EXC	EXEC
EXE	EXEC
EXEC	EXEC
EXECUTOR	EXTR
EXTR	EXTR
EXEMPT	EXMPT
EXMPT	EXMPT
EXEMPTED	EXMPTD
EXMPTD	EXMPTD
EXHIBIT	EXHBT
EXHBT	EXHBT
EXHIBITOR	EXHBTR
EXHBTR	EXHBTR
EXPEDITER	EXPD
EXPD	EXPD
EXPEDITION	EXPDTN
EXP	EXPDTN
EXPDTN	EXPDTN
EXPEDITOR	EXPDTR
EXPDTR	EXPDTR
EXPENSE	EXP
EXP	EXP
EXPERIENCE	EXPRNC
EXPRNC	EXPRNC
EXPERIMENT	EXPRMNT
EXPRMNT	EXPRMNT
EXPERT	EXPR
EXPR	EXPR
EXPRT	EXPR
EXPLORATION	EXPLRN
EXPLRN	EXPLRN
EXPN	EXPLRN
EXPLOSIVE	EXPLSV
EXPL	EXPLSV
EXPLSV	EXPLSV
EXPORT	EXPRT
EXP	EXPRT
EXPRT	EXPRT
EXPT	EXPRT
EXPORTATION	EXPN
EXPN	EXPN
EXPRTTN	EXPN
EXPORTER	EXPRTR
EXP	EXPRTR
EXPRTR	EXPRTR
EXPOSE	EXPS
EXPS	EXPS
EXPOSITION	EXPO
EXPO	EXPO
EXPSTN	EXPO
EXPRESS	EXPRSS
EX	EXPRSS
EXP	EXPRSS
EXPRSS	EXPRSS
EXPRESSION	EXPRSSN
EXPRSSN	EXPRSSN
EXPRESSWAY	EXPY
EXPRSSWY	EXPY
EXPY	EXPY
EXTENSION	EXT
EXT	EXT
EXTNSN	EXT
EXTERMINATING	EXTERM
EXTERM	EXTERM
EXTG	EXTERM
EXTRMNTNG	EXTERM
EXTERMINATOR	EXTRMNTR
EXTRMNTR	EXTRMNTR
EXTRACT	EXTRCT
EXT	EXTRCT
EXTRCT	EXTRCT
EXTRACTOR	EXTRCTR
EXTRCTR	EXTRCTR
EXTRAORDINARY	EXTRRDNRY
EXTRRDNRY	EXTRRDNRY
EXTREME	EXTRM
EXTRM	EXTRM
FABRIC	FBRC
FABR	FBRC
FBRC	FBRC
FABRICATED	FABD
FAB	FABD
FABD	FABD
FABRICATING	FABG
FABG	FABG
FABRICATION	FBRCN
FBRCN	FBRCN
FABRICATOR	FAB
FAB	FAB
FABRICTR	FAB
FBRCTR	FAB
FACILITY	FACLTY
FAC	FACLTY
FACLTY	FACLTY
FACTOR	FCTR
FCTR	FCTR
FACTORY	FCTRY
FAC	FCTRY
FCTRY	FCTRY
FACULTY	FCLTY
FCLTY	FCLTY
FAITH	FTH
FTH	FTH
FALLS	FLS
FLS	FLS
FAMILY	FMLY
FAM	FMLY
FMLY	FMLY
FAMOUS	FMS
FMS	FMS
FANCY	FNCY
FNCY	FNCY
FANTASTIC	FNTSTIC
FNTSTIC	FNTSTIC
FANTASY	FNTSY
FNTSY	FNTSY
FARM	FRM
FRM	FRM
FARMER	FRMR
FRMR	FRMR
FARMING	FRMNG
FRMNG	FRMNG
FASHION	FASHN
FASHN	FASHN
FSHN	FASHN
FASTENER	FAS
FAS	FAS
FATHER	FR
FR	FR
FAUCET	FCT
FCT	FCT
FEATHER	FE
FE	FE
FEDERAL	FED
FDRL	FED
FED	FED
FEDL	FED
FEDRL	FED
FEDERATED	FDRTD
FDRTD	FDRTD
FEDERATION	FEDRN
FEDRN	FEDRN
FELLOWSHIP	FLLWSHP
FELLOWSHP	FLLWSHP
FLLWSHP	FLLWSHP
FLWSHIP	FLLWSHP
FLWSHP	FLLWSHP
FENCE	FNC
FNC	FNC
FERROUS	FER
FER	FER
FERTILIZER	FERT
FERT	FERT
FIBER	FIBR
FIBR	FIBR
FIBERGLASS	FBRGLS
FBRGLS	FBRGLS
FIBRE	FBR
FBR	FBR
FIBR	FBR
FIDELITY	FIDLTY
FDLTY	FIDLTY
FIDLTY	FIDLTY
FIELD	FLD
FLD	FLD
FIFTH	5TH
V	5TH
5TH	5TH
FIGHT	FGHT
FGHT	FGHT
FIGHTER	FGHTR
FGHTR	FGHTR
FINANCE	FIN
FIN	FIN
FNC	FIN
FINANCIAL	FNCL
FINL	FNCL
FNCL	FNCL
FINANCIER	FINR
FIN	FINR
FINR	FINR
FINANCING	FING
FING	FING
FINDING	FNDG
FNDG	FNDG
FINEST	FNST
FNST	FNST
FINISH	FNSH
FINSH	FNSH
FNSH	FNSH
FINISHING	FINISH
FINISH	FINISH
FINSHG	FINISH
FNSHNG	FINISH
FIREARM	FRARM
FRARM	FRARM
FIREMAN	FIRMN
FIRMN	FIRMN
FRMN	FIRMN
FIREWORK	FRWRK
FRWRK	FRWRK
FIRST	1ST
I	1ST
1	1ST
1ST	1ST
FISCAL	FISC
FISC	FISC
FISHERY	FSHRY
FSHRY	FSHRY
FISHING	FSHNG
FSHNG	FSHNG
FITNESS	FITNS
FITNS	FITNS
FIXTURE	FIX
FIX	FIX
FLAVOR	FLVR
FL	FLVR
FLA	FLVR
FLVR	FLVR
FLEET	FLT
FLT	FLT
FLIGHT	FLGT
FLGT	FLGT
FLT	FLGT
FLOCK	FLCK
FLCK	FLCK
FLOOR	FL
FL	FL
FLR	FL
FLOORCOVERING	FLRCVG
FLRCVG	FLRCVG
FLOORING	FLRNG
FLRG	FLRNG
FLRNG	FLRNG
FLORAL	FLRL
FLRL	FLRL
FLORIST	FLRST
FLOR	FLRST
FLRST	FLRST
FLOWER	FLWR
FLWR	FLWR
FLUID	FLUD
FLD	FLUD
FLUD	FLUD
FLYING	FLY
FLY	FLY
FOCUS	FCS
FCS	FCS
FOOTBALL	FTBLL
FTBLL	FTBLL
FOOTWEAR	FTWR
FTWR	FTWR
FORCE	FRC
FOR	FRC
FRC	FRC
FORECASTING	FRCSTNG
FRCSTNG	FRCSTNG
FOREIGN	FRGN
FGN	FRGN
FRGN	FRGN
FOREMAN	FORMN
FORMN	FORMN
FRMN	FORMN
FORESIGHT	FORSGHT
FORSGHT	FORSGHT
FOREST	FRST
FRST	FRST
FORESTRY	FOR
FOR	FOR
FRSTRY	FOR
FOREVER	FORVR
FORVR	FORVR
FORGING	FRG
FRG	FRG
FORGOING	FORGNG
FRGNG	FORGNG
FORKLIFT	FRKLFT
FRKLFT	FRKLFT
FORMAL	FRML
FRML	FRML
FORMATION	FRMTN
FRMTN	FRMTN
FORTUNE	FRTN
FRTN	FRTN
FORUM	FRUM
FRM	FRUM
FRUM	FRUM
FORWARDING	FWDG
FWDG	FWDG
FOSTER	FSTR
FSTR	FSTR
FOUND	FND
FND	FND
FOUNDATION	FNDTN
FDN	FNDTN
FNDTN	FNDTN
FOUNDTN	FNDTN
FOUNDRY	FNDRY
FDRY	FNDRY
FNDRY	FNDRY
FOUNTAIN	FTN
FTN	FTN
FOURGON	FORGN
FORGN	FORGN
FOURTEENTH	14TH
XIV	14TH
14	14TH
14TH	14TH
FOURTH	4TH
IV	4TH
4	4TH
4TH	4TH
FRAGRANCE	FRGRNC
FRGRNC	FRGRNC
FRAME	FRAM
FRAM	FRAM
FRAMEWORK	FRMWRK
FRMWRK	FRMWRK
FRAMING	FRAMG
FRAMG	FRAMG
FRANCHISE	FRNCHS
FRNCHS	FRNCHS
FRANCHISING	FRNCHSNG
FRANCHSNG	FRNCHSNG
FRATERNAL	FRTRNL
FRTRNL	FRTRNL
FRATERNITY	FRTRNTY
FRTRNTY	FRTRNTY
FREEWAY	FWY
FRWY	FWY
FWY	FWY
FREEZE	FREZ
FREZ	FREZ
FRZ	FREZ
FREEZER	FRZR
FRZR	FRZR
FREIGHT	FRGHT
FRGHT	FRGHT
FRGT	FRGHT
FRT	FRGHT
FRENCH	FRNCH
FRNCH	FRNCH
FRESH	FRSH
FRSH	FRSH
FRIARY	FRY
FRY	FRY
FRICTION	FRCTN
FRCTN	FRCTN
FRIED	FRD
FRD	FRD
FRIEND	FRND
FRND	FRND
FRIENDLY	FRNDLY
FRNDLY	FRNDLY
FRONTIER	FRNTR
&nbsp;	FRNTR
FRNTR	
FRZ	FRZN
FRT	FRT
FUNCTL	FUNCTL
FUNCTRY	FUNCTRY
FNDMNTLST	FNDMNTLST
FNDNG	FNDNG
FNRL	FNRL
FRNC	FURN
FURNG	FURNG
FURN	FURN
FUR	FUR
FUSL	FUSL
FUSN	FUSN
GALXY	GALXY
GLLRY	GLLRY
GLVNZNG	GLVNZNG
GRGE	GRGE
GDNS	GRDN
GRDNR	GRDNR
GMT	GMT
GAS	GAS
GASTRNTRLGST	GASTRNTRLGST
GASTRNTRLGY	GASTRNTRLGY
GTWY	GTWY
GTHRNG	GTHRNG
GAZ	GAZ
GEN	GN
GNRTNG	GNRTNG
GNRTN	GNRTN
GNRTR	GNRTR
GNSS	GNSS
GNTLMN	GNTLMN
GDSC	GDSC
GEOLGCL	GEOLGCL
GEOL	GEOL
GEOLGY	GEOLGY
GEOPHYS	GEOPHYS
GERI	GERI
GNT	GNT
GFTWR	GFTWR
GNGRBRD	GNGRBRD
GLC	GLC
GLDTR	GLDTR
GLS	GLS
GLWR	GLWR
GLZ	GLZ
GLBL	GLBL
GLV	GLV
GLDN	GLDN
GSPL	GSPL
GRMT	GRMT
GOVT	GOVT
GVRNMNTL	GVRNMNTL
GOV	GVRNR
GRC	GRC
GRDE	GRDE
GRAD	GRAD
GRAN	GRN
GRND	GRND
GRNDMA	GRNDMA
GRNDPA	GRNDPA
GRNT	GRNT
GRPHC	GRPHC
GRVL	GRVL
GRT	GRT
GRTR	GRTR
GRN	GRN
GRNHS	GRNHSE
GRTG	GRTG
GRL	GRL
GRNDR	GRNDR
GRIND	GRNDG
GROC	GROC
GROCY	GROCY
GROOM	GROOM
GRP	GRP
GRV	GRV
GRNTD	GRNTD
GRD	GRD
GRDN	GRDN
GUIDNC	GUIDNC
GUID	GUID
GLD	GLD
GY	GY
GNSMTH	GNSMTH
GYM	GYM
GYN	GYNCLGST
GYNCLGY	GYNCLGY
GYPS	GYPS
HDASHY	HDASHY
HAIRCTTNG	HAIRCTTNG
HRDRSSR	HRDRSSR
HRSTYLNG	HRSTYLNG
HRSTYLST	HRSTYLST
HLLMRK	HLLMRK
HAMBGR	HMBG
HBAG	HBAG
HNDCPD	HNDCPD
HNDCRFT	HNDCRFT
HNDLR	HNDLR
HNDLG	HNDLING
HNDPRNT	HNDPRNT
HNDY	HNDY
HNDYMN	HNDYMN
HAP	HAP
HBR	HRBOR
HDWR	HDWR
HARN	HARN
HTCHY	HTCHY
HLG	HLG
HVN	HVN
HYSTCK	HYSTCK
HDCH	HDCH
HDLNR	&nbsp;
HDQTRS	HQTS
HLTH	HLTH
HEAR	HRNG
HRT	HRT
HTG	HTNG
HVY	HVY
HTS	HT
HLCPTR	HLCPTR
HLPR	HLPR
HEMATL	HEMATL
HEMATLGY	HEMATLGY
HRTG	HRTG
HRMTG	HRMTG
HCKRY	HCKRY
HDWY	HDWY
HGHR	HGHR
HGLND	HGLND
HWY	HWY
HLTP	HLTP
HISTRCL	HISTRCL
HTCHNG	HTCHNG
HOB	HOB
HLDNG	HOLDG
HLDY	HLDY
HLNSS	HLNSS
HMSTD	HMSTD
HMWRK	HMWRK
HNYB	HNYB
HON	HON
HRZN	HRZN
HORSE	HRS
HORTL	HORTL
HORT	HORT
HSY	HSY
HSPC	HSPC
HOSP	HSPTL
HOSPTY	HOSPTY
HTL	HTL
HSE	HSE
HSEHLD	HSEHLD
HSWRS	HSWRS
HSNG	HSNG
HMN	HMN
HNGRY	HNGRY
HNTR	HNTR
HYDRLC	HYDRLC
HYGN	HYGN
HYPNS	HYPNS
IDL	IDL
IGN	IGN
IMG	IMG
IMGNTN	IMGNTN
IMGNG	IMGNG
IMMCLT	IMMCLT
IMMDT	IMMDT
IMMGRTN	IMMGRTN
IMP	IMP
IMPRD	IMPRD
IMPDMNT	IMPDMNT
IMPRL	IMPRL
IMPL	IMPT
IMPLNTN	IMPLNTN
IMPRT	IMPRT
IMPN	IMPN
IMPRTD	IMPRTD
IMPRTR	IMPRTR
IMPRTNG	IMPRTNG
IMPRESS	IMPRESS
IMPRVMT	IMPRVMT
INCRNTN	INCRNTN
INCM	INCO
INC	INCORP
INCTN	INCTN
INDMNTY	INDMNTY
INDPDNC	INDPDNC
INDPNDNT	INDPNDNT
INDN	INDN
IND	INDUSTRL
INDUST	INDUSTR
INFNT	INFNT
INFINT	INFINT
INFRM	INFRM
INFRMRY	INFRMRY
INF	INF
INFRMTCS	INFRMTCS
INFO	INFOR
INGRDNT	INGRDNT
INIT	INTL
INJCTN	INJCTN
INLND	INLND
INNR	INNR
INNKPR	INNKPR
INNCNT	INNCNT
INNVTN	INNVTN
INNVTV	INNVTV
INQSTV	INQSTV
INSCRPTN	INSCRPTN
INSCR	INSCR
INSPCTN	INSPTN
INSPCTR	INSPCTR
INSTLTN	INSTLTN
INSTLLR	&nbsp;
INSTALLMENT	INSTL
&nbsp;	INSTL
INSTL	
INSTNT	&nbsp;
INSTITUTE	INST
INST	INST
INSTI	INST
INSTIT	INST
INSTITUE	INST
INSTITUT	INST
INSTITUTION	INSTN
INSTN	INSTN
INSTITUTIONAL	INSTNL
INSTNL	INSTNL
INSTRUCTOR	INSTRCTR
INST	INSTRCTR
INSTR	INSTRCTR
INSTRCTR	INSTRCTR
INSTRUMENT	INSTR
INSTR	INSTR
INSTRUMENTATION	INSTRMNTN
INSTRMNTN	INSTRMNTN
INSTRUMENTA	INSTRMNTN
INSULATED	INSLTD
INSLTD	INSLTD
INSULATING	INSULG
INSULG	INSULG
INSULATION	INSLTN
INSLTN	INSLTN
INSUL	INSLTN
INSULATN	INSLTN
INSURANCE	INS
INS	INS
INSUR	INS
INSURAN	INS
INTEGRATED	INTGRTD
INTGRTD	INTGRTD
INTELLIGENCE	INTLLGNC
INTLLGNC	INTLLGNC
INTENTIONAL	INTNTNL
INTNTL	INTNTNL
INTERACTION	INTRCTN
INTER	INTRCTN
INTRCTN	INTRCTN
INTERACTIVE	INTRCTV
INTRCTV	INTRCTV
INTERCHANGE	INTRCHNG
INTRCHNG	INTRCHNG
INTERCONTINENTAL	INTERCON
INTERCON	INTERCON
INTEREST	INTRST
INTRST	INTRST
INTERFAITH	INTRFTH
INTRFTH	INTRFTH
INTERIOR	INTR
INT	INTR
INTR	INTR
INTERMEDIATE	INTER
INTER	INTER
INTERMED	INTER
INTERMEDICS	INTRMDCS
INTRMDCS	INTRMDCS
INTERNAL	INTERNL
INTER	INTERNL
INTERNL	INTERNL
INTERNATIONAL	INTRNTL
INTERNATI	INTRNTL
INTERNATIO	INTRNTL
INTERNATION	INTRNTL
INTERNATIONA	INTRNTL
INTERNATL	INTRNTL
INTL	INTRNTL
INTNL	INTRNTL
INTRNTL	INTRNTL
INTRNTNL	INTRNTL
INTERNIST	INTERNST
INTER	INTERNST
INTERNST	INTERNST
INTERSTATE	INTSTE
INTRST	INTSTE
INTSTE	INTSTE
INTERVIEWER	INTERV
INTERV	INTERV
INVENTORY	INVTY
INVEN	INVTY
INVTY	INVTY
INVEST	INVST
INVST	INVST
INVESTED	INVSTD
INVSTD	INVSTD
INVESTIGATION	INVSTGTN
INVSTGTN	INVSTGTN
INVESTIGATIVE	INVSTGTV
INVSTGTV	INVSTGTV
INVESTIGATOR	INVSTR
INVSTR	INVSTR
INVESTMENT	INVSTMNT
INV	INVSTMNT
INVESTMNT	INVSTMNT
INVESTMT	INVSTMNT
INVST	INVSTMNT
INVSTMNT	INVSTMNT
INVSTMT	INVSTMNT
INVITATIONAL	INVTNL
INVTNL	INVTNL
INVOICE	INV
INV	INV
IRONWORK	IRNWRK
IRNWRK	IRNWRK
IRRIGATION	IRRGTN
IRRGTN	IRRGTN
IRRIG	IRRGTN
IRRIGAT	IRRGTN
ISLAND	ISLE
IS	ISLE
ISL	ISLE
ISLE	ISLE
ISLANDER	ISLER
ISLER	ISLER
ISOLATION	ISO
ISO	ISO
ISOTOPE	ISTP
ISTP	ISTP
ITALIAN	ITAL
IT	ITAL
ITAL	ITAL
ITLN	ITAL
JAILER	JLR
JLR	JLR
JANITOR	JAN
JAN	JAN
JANITORIAL	JANTRL
JAN	JANTRL
JANITOR	JANTRL
JNTRL	JANTRL
JEWELER	JWLR
JWLR	JWLR
JEWELRY	JWLRY
JEWLRY	JWLRY
JWLRY	JWLRY
JWLY	JWLRY
JEWISH	JEW
JEW	JEW
JOBBER	JOB
JOB	JOB
JOINT	JNT
JNT	JNT
JOURNAL	JRNL
JRNL	JRNL
JOURNALIST	JRNLST
JRNLST	JRNLST
JOURNEY	JRNY
JRNY	JRNY
JUBILEE	JBL
JBL	JBL
JUDGE	JDG
JD	JDG
JDG	JDG
JUICE	JC
JC	JC
JUNCTION	JCT
JC	JCT
JCT	JCT
JCTION	JCT
JCTN	JCT
JUNCTN	JCT
JUNCTON	JCT
JUNIOR	JR
JR	JR
JUSTICE	JSTC
JSTC	JSTC
JUVENILE	JVNL
JVNL	JVNL
KARATE	KRT
KRT	KRT
KENNEL	KNL
KNL	KNL
KEYBOARD	KYBRD
KYBRD	KYBRD
KEYSTONE	KEYSTN
KEYSTN	KEYSTN
KIDDIE	KID
KID	KID
KINDERGARTEN	KINDERGTN
KDRGRTN	KINDERGTN
KINDERGTN	KINDERGTN
KNDGTRN	KINDERGTN
KNDRGRTN	KINDERGTN
KINEMATICS	KNMTCS
KNMTCS	KNMTCS
KINGDOM	KNGDM
KNGDM	KNGDM
KITCHEN	KTCHN
KIT	KTCHN
KTCHN	KTCHN
KTN	KTCHN
KNIGHT	KNGHT
KNGHT	KNGHT
KNT	KNGHT
KNITTED	KNTTD
KNTTD	KNTTD
KNITTING	KNT
KNT	KNT
KNITWEAR	KNTWR
KNTWR	KNTWR
KOSHER	KSHR
KSHR	KSHR
LABEL	LBL
LAB	LBL
LBL	LBL
LABORATORY	LAB
LAB	LAB
LABORER	LBR
LBR	LBR
LACQUER	LACQ
LACQ	LACQ
LAMINATE	LMNT
LMNT	LMNT
LAMINATING	LMNTNG
LMNTNG	LMNTNG
LANCE	LNC
LNC	LNC
LANDFILL	LNDFLL
LNDFLL	LNDFLL
LANDMARK	LNDMRK
LNDMRK	LNDMRK
LANDSCAPE	LNDSCP
LANDSCP	LNDSCP
LDSCP	LNDSCP
LNDSCP	LNDSCP
LANDSCAPING	LANDSCPG
LANDSCPG	LANDSCPG
LDSCPG	LANDSCPG
LNDSCPG	LANDSCPG
LANGUAGE	LANG
LANG	LANG
LAPIDARY	LAPDRY
LAPDRY	LAPDRY
LARGE	LRGE
LRGE	LRGE
LARYNGOLOGIST	LARYNGLGST
LAR	LARYNGLGST
LARYNGLGST	LARYNGLGST
LARYNGOLOGY	LARYNGLGY
LAR	LARYNGLGY
LARYNGLGY	LARYNGLGY
LASER	LSR
LSR	LSR
LASTING	LSTNG
LSTNG	LSTNG
LATHING	LTHG
LTHG	LTHG
LATTER	LTTR
LTTR	LTTR
LAUNDERER	LDRER
LDRER	LDRER
LAUNDROMAT	LNDRMT
LNDRMT	LNDRMT
LAUNDRY	LNDRY
LDRY	LNDRY
LNDRY	LNDRY
LAWYER	LWYR
LGL	LWYR
LWYR	LWYR
LEADER	LDR
LDR	LDR
LEAGUE	LEA
LEA	LEA
LEAG	LEA
LGE	LEA
LEARNING	LEARN
LEARN	LEARN
LRNG	LEARN
LEASE	LS
LEAS	LS
LS	LS
LEASING	LEASE
LEASE	LEASE
LSG	LEASE
LSNG	LEASE
LEATHER	LTHR
LEA	LTHR
LTHR	LTHR
LECTURE	LECT
LECT	LECT
LECTURER	LECTR
LEC	LECTR
LECT	LECTR
LECTR	LECTR
LEGAL	LGL
LEG	LGL
LGL	LGL
LEGION	LGN
LGN	LGN
LEISURE	LSUR
LSR	LSUR
LSUR	LSUR
LENGTH	LNGTH
LNGTH	LNGTH
LESSOR	LSSR
LSSR	LSSR
LETTER	LTR
LTE	LTR
LTR	LTR
LETTERPRESS	LTRPRS
LTRPRS	LTRPRS
LEVER	LVR
LVR	LVR
LIABILITY	LBLTY
LBLTY	LBLTY
LIBERTY	LBRTY
LBRTY	LBRTY
LIBTY	LBRTY
LIBRARIAN	LIBRN
LBRN	LIBRN
LIB	LIBRN
LIBR	LIBRN
LIBRN	LIBRN
LIBRARY	LBRY
LBRRY	LBRY
LBRY	LBRY
LIB	LBRY
LIBRAR	LBRY
LIBRY	LBRY
LICENSED	LCNSD
LCNSD	LCNSD
LIEUTENANT	LT
LT	LT
LIGHT	LGT
LGT	LGT
LIT	LGT
LIGHTER	LGHTR
LGHTR	LGHTR
LIGHTING	LIGHT
LGHTG	LIGHT
LIGHT	LIGHT
LTG	LIGHT
LIMIT	LMT
LMT	LMT
LIMITED	LTD
LMTD	LTD
LTD	LTD
LIMITLESS	LMTLSS
LMTLSS	LMTLSS
LIMOUSINE	LIMO
LIMO	LIMO
LIMOSINE	LIMO
LIMSNE	LIMO
LINEN	LIN
LIN	LIN
LINGERIE	LNGR
LNGR	LNGR
LINOLEUM	LNLM
LNLM	LNLM
LIQUID	LQD
LQD	LQD
LIQUOR	LQR
LQ	LQR
LQR	LQR
LITHOGRAPH	LITHO
LITHO	LITHO
LITHOGRAPHER	LITHOR
LITHO	LITHOR
LITHOR	LITHOR
LITHOGRAPHIC	LITHOC
LITHOC	LITHOC
LITHOGRAPHING	LITHOG
LITHO	LITHOG
LITHOG	LITHOG
LITHOGRAPHY	LITHOY
LITHOY	LITHOY
LITTLE	LTL
LTL	LTL
LIVERY	LV
LV	LV
LIVESTOCK	LVSTCK
LVSTCK	LVSTCK
LVSTK	LVSTCK
LIVING	LVNG
LVNG	LVNG
LOADER	LODR
LDR	LODR
LODR	LODR
LOADING	LDNG
LDNG	LDNG
LOBSTER	LBSTR
LBSTR	LBSTR
LOCAL	LCL
LCL	LCL
LOC	LCL
LOCATION	LCTN
LCTN	LCTN
LOCKER	LCKR
LCKR	LCKR
LOCKSMITH	LOKSMTH
LCKSMTH	LOKSMTH
LOCKSMTH	LOKSMTH
LSMITH	LOKSMTH
LOCOMOTIVE	LOCOM
LOCOM	LOCOM
LODGE	LDG
LDG	LDG
LDGE	LDG
LODG	LDG
LOGGING	LOG
LOG	LOG
LOGIC	LGC
LGC	LGC
LOGICAL	LGCL
LGCL	LGCL
LOGISTIC	LOGISTC
LOGISTC	LOGISTC
LOGS	LOGISTC
LOGISTICIAN	LOGISTN
LOUNGE	LNG
LNG	LNG
LUBRICANT	LUBR
LUBR	LUBR
LUBRICNT	LUBR
LUBRICATION	LUBE
LUBE	LUBE
LUCKY	LCKY
LCKY	LCKY
LUGGAGE	LUG
LUG	LUG
LUMBER	LMBR
LBR	LMBR
LMBR	LMBR
LUTHERAN	LUTH
LUTH	LUTH
MACARONI	MCRN
MCRN	MCRN
MACHINE	MACH
MACH	MACH
MCH	MACH
MCHINE	MACH
MACHINER	MACHR
MACH	MACHR
MACHR	MACHR
MACHINERY	MACHY
MACH	MACHY
MACHY	MACHY
MCHY	MACHY
MACHINING	MACHG
MACH	MACHG
MACHG	MACHG
MACHINIST	MACHST
MACH	MACHST
MACHST	MACHST
MAGAZINE	MAG
MAG	MAG
MAGIC	MGC
MGC	MGC
MAGNETIC	MGNTC
MGNTC	MGNTC
MAGNETO	MGNTO
MGNTO	MGNTO
MAILER	MLR
MLR	MLR
MAILSTOP CODE	MSC
MS	MSC
MS#	MSC
MSC	MSC
MAINSAIL	MNSL
MNSL	MNSL
MAINTENANCE	MNTNC
MAINT	MNTNC
MNTNC	MNTNC
MTNCE	MNTNC
MAJESTIC	MJSTC
MJSTC	MJSTC
MAJOR	MJR
MAJ	MJR
MJR	MJR
MAMMOGRAPHY	MAMGRAPHY
MAMGRPHY	MAMGRAPHY
MANAGE	MANAG
MANAG	MANAG
MNG	MANAG
MANAGEMENT	MGMT
MANAGE	MGMT
MANGMNT	MGMT
MGMENT	MGMT
MGMT	MGMT
MGT	MGMT
MNGMNT	MGMT
MNGMT	MGMT
MNGN	MGMT
MANAGER	MGR
MANAGE	MGR
MG	MGR
MGR	MGR
MNAGER	MGR
MNGR	MGR
MANAGERIAL	MGRL
MGRL	MGRL
MANAGING	MNGNG
MGNG	MNGNG
MNG	MNGNG
MNGNG	MNGNG
MANOR	MNR
MNR	MNR
MANPOWER	MNPWR
MNPWR	MNPWR
MANUFACTURE	MFR
MANF	MFR
MANUF	MFR
MFR	MFR
MANUFACTURER	MFGR
MFGR	MFGR
MFR	MFGR
MANUFACTURING	MFG
MANUFACTURI	MFG
MFG	MFG
MFGNG	MFG
MAPLE	MPL
MPL	MPL
MARATHON	MRTHN
MRTHN	MRTHN
MARBLE	MRBL
MBL	MRBL
MRBL	MRBL
MARINA	MRNA
MRNA	MRNA
MARINE	MRNE
MAR	MRNE
MRNE	MRNE
MARITIME	MRTM
MRTM	MRTM
MARKET	MKT
MKT	MKT
MRKT	MKT
MARKETER	MRKTR
MRKTR	MRKTR
MARKETING	MKTG
MKT	MKTG
MKTG	MKTG
MKTING	MKTG
MKTNG	MKTG
MRKT	MKTG
MRKTG	MKTG
MARKETPLACE	MRKTPLC
MRKTPLC	MRKTPLC
MARKING	MKG
MKG	MKG
MARSHALL	MRSHLL
MRSHLL	MRSHLL
MASON	MSN
MSN	MSN
MASONIC	MSNC
MSNC	MSNC
MASONRY	MASON
MASON	MASON
MSN	MASON
MASTER	MSTR
MSTR	MSTR
MATERIAL	MTRL
MATL	MTRL
MTL	MTRL
MTRL	MTRL
MATERIEL	MATL
MTREL	MATL
MATERNITY	MTRNTY
MTRNTY	MTRNTY
MATTRESS	MATRS
MAT	MATRS
MATRS	MATRS
MATT	MATRS
MATTRS	MATRS
MAYOR	MAY
MAY	MAY
MYR	MAY
MEADOW	MDWS
MDW	MDWS
MEASURE	MSR
MSR	MSR
MEASUREMENT	MSRMNT
MEASUREMNT	MSRMNT
MSRMNT	MSRMNT
MECHANIC	MECH
MCHNC	MECH
MECH	MECH
MECHANICAL	MECHL
MECH	MECHL
MECHL	MECHL
MEDIA	MEDIA
MED	MEDIA
MEDICAL	MEDCL
MDCL	MEDCL
MED	MEDCL
MEDCL	MEDCL
MEDIC	MEDCL
MEDL	MEDCL
MEDICAMENT	MEDCMNT
MEDCMNT	MEDCMNT
MEDICINE	MEDCN
MED	MEDCN
MEDCN	MEDCN
MEDIUM	MEDM
MED	MEDM
MEDM	MEDM
MEETING	MTG
MTG	MTG
MELANGE	MLNG
MLNG	MLNG
MEMBER	MBR
MBR	MBR
MEMBERSHIP	MBRSHP
MBRSHP	MBRSHP
MEMBRANE	MBRM
MBRM	MBRM
MEMORANDUM	MEMO
MEMO	MEMO
MEMORIAL	MEML
MEM	MEML
MEML	MEML
MEMRL	MEML
MEMORY	MEM
MEM	MEM
MENNONITE	MENIT
MENIT	MENIT
MENTAL	MNTL
MENT	MNTL
MNTL	MNTL
MERCANTILE	MERCTL
MERC	MERCTL
MERCTL	MERCTL
MERCHANDISE	MDSE
MDSE	MDSE
MERCHANDISER	MRCHNDSR
MRCHNDSR	MRCHNDSR
MERCHANDISING	MDSNG
MDSNG	MDSNG
MERCH	MDSNG
MHDSG	MDSNG
MERCHANT	MRCHNT
MCHNT	MRCHNT
MRCHNT	MRCHNT
MERCURY	MERC
MERC	MERC
MERIDIONAL	MRDNL
MRDNL	MRDNL
METAL	METL
MET	METL
METL	METL
MTL	METL
METALLIZING	MTLNG
MTLNG	MTLNG
METALLURGICAL	METLLRGCL
MET	METLLRGCL
METLLRGCL	METLLRGCL
METALLURGIST	METLLRGST
MET	METLLRGST
METLLRGST	METLLRGST
METALLURGY	MTLGY
MTLGY	MTLGY
METEOROLOGIST	METRLGST
MET	METRLGST
METRLGST	METRLGST
METHOD	METH
METH	METH
METHODIST	METHDST
METH	METHDST
METHDST	METHDST
METRIC	MTRC
MTRC	MTRC
METROPOLITAN	METRO
METRO	METRO
MEXICAN	MEX
MEX	MEX
MICRO	MCR
MCR	MCR
MICROBIOLOGY	MCRBLGY
MCRBLGY	MCRBLGY
MICROCOMPUTER	MCRCMPTR
MCRCMPTR	MCRCMPTR
MICRO	MCRCMPTR
MICRODATA	MCRDT
MCRDT	MCRDT
MICROELECTRONIC	MCRELCTRNC
MCRELCTRNC	MCRELCTRNC
MICROFICHE	MCRFCH
MCRFCH	MCRFCH
MICROWAVE	MCRWV
MCRWV	MCRWV
MIDDLE	MID
MID	MID
MIDL	MID
MIDLAND	MDLND
MDLND	MDLND
MIDSHIPMAN	MDSHPMN
MDSHPMN	MDSHPMN
MIDTOWN	MDTWN
MDTWN	MDTWN
MIDWAY	MDWY
MDWY	MDWY
MIDWEST	MDWST
MDWST	MDWST
MIDWST	MDWST
MIDWESTERN	MDWSTRN
MDWSTRN	MDWSTRN
MILIEU	ML
ML	ML
MILITARY	MLTRY
MLTRY	MLTRY
MILLINERY	MILNRY
MLY	MILNRY
MILLING	MIL
MIL	MIL
MILLWORK	MLLWK
MLLWK	MLLWK
MINERAL	MNRL
MIN	MNRL
MNRL	MNRL
MINIATURE	MINI
MINI	MINI
MINING	MIN
MIN	MIN
MINNG	MIN
MINISTER	MINSTR
MNTR	MINSTR
MINISTRY	MNSTRY
MNSTRY	MNSTRY
MINISCULE	MNSCL
MNSCL	MNSCL
MIRROR	MIR
MIR	MIR
MISCELLANEOUS	MISC
MISC	MISC
MISSILE	MIS
MIS	MIS
MISSION	MSSN
MSN	MSSN
MSSN	MSSN
MISSIONARY	MSSNRY
MSSNRY	MSSNRY
MISTER	MR
MR	MR
MIXED	MXD
MXD	MXD
MIXING	MIX
MIX	MIX
MOBILE	MBL
MBL	MBL
MO	MBL
MOB	MBL
MOCCASIN	MOC
MOC	MOC
MODEL	MDL
MDL	MDL
MODERN	MOD
MDRN	MOD
MOD	MOD
MOLDED	MLD
MLD	MLD
MOLDING	MLDG
MLDG	MLDG
MONASTERY	MONSTRY
MONSTRY	MONSTRY
MONEY	MNY
MNY	MNY
MONITORING	MNTRNG
MNTRNG	MNTRNG
MONOGRAM	MNGRM
MNGRM	MNGRM
MONTHLY	MNTHLY
MNTHLY	MNTHLY
MONUMENT	MNMT
MNMT	MNMT
MONU	MNMT
MOOSE	MSE
MSE	MSE
MORTGAGE	MRTG
MORTG	MRTG
MORTGE	MRTG
MRTG	MRTG
MRTGE	MRTG
MTG	MRTG
MTGE	MRTG
MORTICIAN	MORT
MORT	MORT
MORTUARY	MRTRY
MRTRY	MRTRY
MOSAIC	MOSC
MSC	MOSC
MOTEL	MTL
MTL	MTL
MOTHER	MTHR
MTHR	MTHR
MOTIF	MTF
MTF	MTF
MOTION	MOTN
MOTN	MOTN
MTN	MOTN
MOTOR	MTR
MTR	MTR
MOTORCYCLE	MTRCYL
MTCYC	MTRCYL
MOULAGE	MLG
MLG	MLG
MOULDING	MLDNG
MLDNG	MLDNG
MOUNT	MT
MT	MT
MOUNTAIN	MTN
MNTN	MTN
MOUNTIN	MTN
MTN	MTN
MOVEMENT	MVMNT
MVMNT	MVMNT
MOVER	MVR
MVR	MVR
MOVIE	MOV
MOV	MOV
MOVING	MOVE
MOVE	MOVE
MVG	MOVE
MOWER	MWR
MWR	MWR
MUFFLER	MUFLR
MFLR	MUFLR
MUFLR	MUFLR
MUNICIPAL	MNCPL
MNCPL	MNCPL
MUNICIPALITY	MNCPLTY
MNCPLTY	MNCPLTY
MUSEUM	MUS
MUS	MUS
MUSIC	MUSC
MUS	MUSC
MUSC	MUSC
MUSICAL	MUSCL
MUSCL	MUSCL
MUTUAL	MUTL
MTL	MUTL
MUTL	MUTL
MYSTIC	MYSTC
MYSTC	MYSTC
NATION	NAT
NAT	NAT
NATIONAL	NATL
NATL	NATL
NTL	NATL
NATIONWIDE	NTNWD
NTNWD	NTNWD
NATURAL	NTRL
NTRL	NTRL
NATURALLY	NTRLLY
NTRLLY	NTRLLY
NAUTICAL	NTCL
NTCL	NTCL
NAVAL	NVL
NVL	NVL
NAVEL	NVEL
NVEL	NVEL
NAVIGATION	NVGTN
NVGTN	NVGTN
NAZARENE	NAZ
NAZ	NAZ
NECESSITY	NEC
NEC	NEC
NECKWEAR	NCKWR
NCKWR	NCKWR
NEIGHBORHOOD	NGHBRHD
NGHBRHG	NGHBRHD
NEPHROLOGY	NEPH
NEPH	NEPH
NETWORK	NTWRK
NET	NTWRK
NETWK	NTWRK
NTK	NTWRK
NTWK	NTWRK
NTWRK	NTWRK
NETWORKING	NTWRKNG
NTWRKNG	NTWRKNG
NEUROBIOLOGY	NEUROBIOL
NEUROBIOL	NEUROBIOL
NEUROLOGIST	NEUROLGST
NEUROLGST	NEUROLGST
NEUROLOGY	NRLGY
NRLGY	NRLGY
NEWSPAPER	NWSPPR
NSWPPR	NWSPPR
NINTH	9TH
IX	9TH
9TH	9TH
NONCOMMISSIONED	NC
NC	NC
NONFERROUS	NFER
NFER	NFER
NORTHERN	NTHRN
NTHRN	NTHRN
NORTHSIDE	NRTHSD
NRTHSD	NRTHSD
NORTHWESTERN	NWN
NWN	NWN
NOTION	NOT
NOT	NOT
NOVELTY	NOVLT
NOVLT	NOVLT
NUCLEAR	NUC
NUC	NUC
NURSE	NUR
NUR	NUR
NURSERY	NRSY
NRSY	NRSY
NURS	NRSY
NURSING	NURSE
NURSE	NURSE
NUTRITION	NUTRI
NTRTN	NUTRI
NUTRI	NUTRI
OBSERVATORY	OBSRVTRY
OBSRVTRY	OBSRVTRY
OBSTETRIC	OBST
OBST	OBST
OBSTETRICIAN	OB
OB	OB
OBSTRCN	OB
OCCUPATION	OCCUPTN
OCCUPTN	OCCUPTN
OCCUPATIONAL	OCCUPTNL
OCCUP	OCCUPTNL
OCCUPTNL	OCCUPTNL
OCEAN	OCN
OCN	OCN
OFFICE	OFC
OFC	OFC
OFCE	OFC
OFF	OFC
OFFC	OFC
OFFICER	OFCR
OFFICR	OFCR
OFFR	OFCR
OFFICIAL	OFCL
OFCL	OFCL
ONCOLOGIST	ONCOL
ONCOL	ONCOL
OPERATING	OPG
OP	OPG
OPG	OPG
OPRTNG	OPG
OPERATION	OPRN
OP	OPRN
OPER	OPRN
OPN	OPRN
OPR	OPRN
OPRN	OPRN
OPERATIONAL	OPRTNL
OP	OPRTNL
OPRTNL	OPRTNL
OPERATIVE	OPTV
OPER	OPTV
OPTV	OPTV
OPERATOR	OPR
OP	OPR
OPER	OPR
OPR	OPR
OPRTR	OPR
OPHTHALMIC	OPHT
OPHT	OPHT
OPHTHALMOLOGIST	OPH
OPH	OPH
OPPORTUNITY	OPRTNTY
OPRTNTY	OPRTNTY
OPTICAL	OPTIC
OPT	OPTIC
OPTIC	OPTIC
OPTICIAN	OPTCN
OPT	OPTCN
OPTCN	OPTCN
OPTOMETRIST	OPTOM
OPTOM	OPTOM
ORANGE	ORNG
ORNG	ORNG
ORCHARD	ORCH
ORCH	ORCH
ORCHRD	ORCH
ORDER	ORDR
ORD	ORDR
ORDR	ORDR
ORDERING	ORDNG
ORDNG	ORDNG
ORDINATOR	ORDNTR
ORDNTR	ORDNTR
ORDNANCE	ORD
ORD	ORD
ORGANIZATION	ORGN
ORGN	ORGN
ORGANIZATIONAL	ORGNL
ORGNL	ORGNL
ORIENTAL	ORNTL
ORNTL	ORNTL
ORNAMENTAL	ORNMTL
ORNA	ORNMTL
ORNMTL	ORNMTL
ORTHOPEDIC	ORTHO
ORTHO	ORTHO
ORTHPD	ORTHO
ORTHOPTIST	ORTHOPTST
ORTHOPTST	ORTHOPTST
OSTEOPATH	OSTEOPTH
OSTEO	OSTEOPTH
OSTEOPTH	OSTEOPTH
OSTEOPATHIC	OSTEOPTHC
OSTEO	OSTEOPTHC
OSTEOPTHC	OSTEOPTHC
OTOLOGY	OTO
OTO	OTO
OTORHINOLRYNGY	OTRHNLRYNGY
OTRHNLRYNGY	OTRHNLRYNGY
OUTDOOR	OTDR
OTDR	OTDR
OUTLET	OUTLT
OTLT	OUTLT
OUTL	OUTLT
OUTLT	OUTLT
OVERHEAD	OVRHD
OVRHD	OVRHD
OVERSIGHT	OVRSGHT
OVRSGHT	OVRSGHT
OWNER	OWNR
ONR	OWNR
OWN	OWNR
OWNE	OWNR
OWNR	OWNR
OWR	OWNR
PACIFIC	PAC
PAC	PAC
PCF	PAC
PACKAGE	PKG
PKG	PKG
PACKAGING	PKGNG
PACKG	PKGNG
PKG	PKGNG
PKGNG	PKGNG
PACKER	PKR
PKR	PKR
PACKING	PCKG
PCKG	PCKG
PKG	PCKG
PADDING	PDG
PDG	PDG
PAINT	PNT
PNT	PNT
PAINTER	PNTR
PNTR	PNTR
PTR	PNTR
PAINTING	PAINT
PAINT	PAINT
PNT	PAINT
PNTG	PAINT
PNTNG	PAINT
PALACE	PALC
PALC	PALC
PLC	PALC
PANCAKE	PNCK
PNCK	PNCK
PANHANDLE	PNHDL
PNHDL	PNHDL
PANTRY	PNTRY
PNTRY	PNTRY
PAPER	PPR
PPR	PPR
PAPERBOARD	PPRBD
PPRBD	PPRBD
PARADISE	PRDS
PRDS	PRDS
PARKING	PARK
PARK	PARK
PRKG	PARK
PARKWAY	PKWY
PKWY	PKWY
PKY	PKWY
PARLOR	PRLR
PRLR	PRLR
PARTICLEBOARD	PTLBD
PTLBD	PTLBD
PARTNER	PRTNR
PARTN	PRTNR
PARTNR	PRTNR
PATNR	PRTNR
PRT	PRTNR
PRTNR	PRTNR
PT	PRTNR
PTNR	PRTNR
PTR	PRTNR
PARTNERSHIP	PRTNRSHP
PRTNRSHP	PRTNRSHP
PARTY	PTY
PTY	PTY
PASSENGER	PSSGR
PASS	PSSGR
PASTOR	PSTR
PST	PSTR
PSTR	PSTR
PATCH	PTCH
PTCH	PTCH
PATENT	PATNT
PAT	PATNT
PATNT	PATNT
PATHOLOGIST	PTHLGST
PTHLGST	PTHLGST
PATHOLOGY	PATH
PATH	PATH
PATIO	PAT
PAT	PAT
PATTERN	PTTRN
PTTRN	PTTRN
PAVING	PAVE
PAV	PAVE
PAVE	PAVE
PVG	PAVE
PAWNBROKER	PWNBKR
PWNPKR	PWNBKR
PAYABLE	PAYABL
PAY	PAYABL
PAYABL	PAYABL
PAYMENT	PYMT
PYMT	PYMT
PEDIATRIC	PEDTRC
PED	PEDTRC
PEDTRC	PEDTRC
PEDIATRICIAN	PED
PED	PED
PENNEY	PNY
PNY	PNY
PENINSULA	PEN
PEN	PEN
PENSION	PNSN
PNSN	PNSN
PENTECOSTAL	PENTE
PENT	PENTE
PENTE	PENTE
PNTCSTL	PENTE
PEOPLE	PPL
PPL	PPL
PERFECT	PERF
PERF	PERF
PRFCT	PERF
PERFORMANCE	PERFORM
PERF	PERFORM
PERFORM	PERFORM
PERIODICAL	PERI
PERI	PERI
PERIODONTIST	PRDNTST
PRDNTST	PRDNTST
PERSONAL	PRSNL
PER	PRSNL
PERS	PRSNL
PRSNL	PRSNL
PERSONNEL	PRSNNL
PERS	PRSNNL
PRSNL	PRSNNL
PRSNNL	PRSNNL
PESTICIDE	PST
PST	PST
PETROLEUM	PETRO
PETRO	PETRO
PETTY	PTTY
PTTY	PTTY
PHARMACEUTICAL	PHARML
PHARNL	PHARML
PHRM	PHARML
PHARMACIST	PHRMST
PHARM	PHRMST
PHRMST	PHRMST
PHARMACY	PHARM
PHARM	PHARM
PHRM	PHARM
PHRMCY	PHARM
PHONE	PH
PHN	PH
PHONOGRAPH	PHONO
PHONO	PHONO
PHOTOGRAPH	PHOTO
PHOTO	PHOTO
PHOTOGRAPHER	PHOTOGR
PHOTOGR	PHOTOGR
PHOTOGRAPHY	PHOTO
PHOTO	PHOTO
PHYSICAL	PHYSCL
PHYS	PHYSCL
PHYSCL	PHYSCL
PHYSICIAN	PHYS
PHYS	PHYS
PHYSCN	PHYS
PHYSICIST	PHYST
PHYS	PHYST
PHYST	PHYST
PIANO	PNO
PNO	PNO
PICTURE	PIC
PCTR	PIC
PIC	PIC
PIEDMONT	PDMNT
PDMNT	PDMNT
PIONEER	PNR
PNR	PNR
PIZZA	PZ
PZ	PZ
PZA	PZ
PIZZERIA	PZA
PZ	PZA
PZA	PZA
PLACE	PL
PL	PL
PLAIN	PLN
PLN	PLN
PLANNER	PLNR
PLNR	PLNR
PLANNING	PLAN
PLAN	PLAN
PLG	PLAN
PLN	PLAN
PLNG	PLAN
PLNNG	PLAN
PLANT	PLNT
PLNT	PLNT
PLT	PLNT
PLASTERING	PLST
PLST	PLST
PLASTIC	PLAS
PLAS	PLAS
PLST	PLAS
PLATING	PLTG
PLTG	PLTG
PLATOON	PLTN
PLTN	PLTN
PLAZA	PLZ
PLZ	PLZ
PLEASANT	PLSNT
PLSNT	PLSNT
PLUMBER	PLMBR
PLMBR	PLMBR
PLUMBING	PLBG
PLUMB	PLBG
PLYWOOD	PLYWD
PLYWD	PLYWD
PODIATRIST	PDTRST
PDTRST	PDTRST
POINT	PT
PT	PT
POLICE	PLC
PLC	PLC
POL	PLC
POLICY	PLCY
PLCY	PLCY
POLISHING	POLSG
POLSG	POLSG
POLLUTION	POLTN
POLTN	POLTN
PORTER	PRTR
PRTR	PRTR
PTR	PRTR
POSITION	PSTN
PSTN	PSTN
POSTAL	PSTL
PSTL	PSTL
POSTMASTER	PM
PM	PM
POTTERY	POT
POT	POT
POULTRY	PLTY
PLTY	PLTY
POWER	PWR
PWR	PWR
PRACTICAL	PRACL
PRAC	PRACL
PRACL	PRACL
PRACTICE	PRAC
PRAC	PRAC
PRCTC	PRAC
PRACTITIONER	PRACTNR
PRAC	PRACTNR
PRACTNR	PRACTNR
PRCTTNR	PRACTNR
PRAIRIE	PR
PR	PR
PRECISION	PRCSN
PRCSN	PRCSN
PREFABRICATED	PFAB
PFAB	PFAB
PREFERRED	PREF
PREF	PREF
PREMIER	PREM
PREM	PREM
PREPARATION	PREP
PREP	PREP
PREPARER	PRPRR
PRPRR	PRPRR
PRESBYTERIAN	PRESBY
PRES	PRESBY
PRESBY	PRESBY
PRSBY	PRESBY
PRESCHOOL	PRSCHL
PRSCHL	PRSCHL
PRESCRIPTION	PRESCR
PRESCR	PRESCR
PRESERVING	PRSV
PRSV	PRSV
PRESIDENT	PRES
PR	PRES
PRES	PRES
PRS	PRES
PRESS	PRS
PRS	PRS
PRESSING	PRSG
PRSG	PRSG
PRESTIGE	PRSTG
PRSTG	PRSTG
PREVENTION	PRVNTN
PRVNTN	PRVNTN
PRICE	PRC
PRC	PRC
PRIDE	PRD
PRD	PRD
PRIEST	PRST
PR	PRST
PRST	PRST
PRIME	PRM
PRM	PRM
PRINCE	PRNC
PR	PRNC
PRNC	PRNC
PRINCIPAL	PRIN
PRIN	PRIN
PRINC	PRIN
PRN	PRIN
PRNCPL	PRIN
PRINT	PRT
PRT	PRT
PRINTER	PRINTR
PRINT	PRINTR
PRINTR	PRINTR
PRTR	PRINTR
PRINTING	PRINTG
PRINT	PRINTG
PRINTG	PRINTG
PRNTNG	PRINTG
PRTG	PRINTG
PTG	PRINTG
PRIVATE	PVT
PVT	PVT
PROCESS	PRCS
PRCS	PRCS
PROCES	PRCS
PROCESSING	PRCSG
PRCS	PRCSG
PRCSG	PRCSG
PRCSNG	PRCSG
PROC	PRCSG
PROCESSOR	PRCSR
PRCSR	PRCSR
PROCUREMENT	PRCMNT
PRCMNT	PRCMNT
PROCU	PRCMNT
PRODUCE	PROD
PROD	PROD
PRODUCER	PRODR
PROD	PRODR
PRODR	PRODR
PRODUCING	PRDCNG
PRDCNG	PRDCNG
PRODUCT	PRODT
PRO	PRODT
PROD	PRODT
PRODT	PRODT
PRODUCTION	PRODN
PRD	PRODN
PRDTN	PRODN
PROD	PRODN
PRODCTN	PRODN
PRODN	PRODN
PRODT	PRODN
PRODUCTIVITY	PRDCTVTY
PRDCTVTY	PRDCTVTY
PROFESSIONAL	PRO
PRO	PRO
PROF	PRO
PROFL	PRO
PROFESSOR	PROF
PROF	PROF
PROGRAM	PRGM
PRGM	PRGM
PROG	PRGM
PROGRAMMER	PRGRMR
PRGMR	PRGRMR
PRGRMR	PRGRMR
PROG	PRGRMR
PROGR	PRGRMR
PROGRAMER	PRGRMR
PROGRMMR	PRGRMR
PROGRAMMING	PRGMNG
PRGMNG	PRGMNG
PROGRESSIVE	PROGS
PROG	PROGS
PROGS	PROGS
PROJECT	PROJ
PRJ	PROJ
PROJ	PROJ
PROMOTION	PROM
PROM	PROM
PROPANE	PROPN
LPG	PROPN
PROPN	PROPN
PRPN	PROPN
PROPERTY	PROP
PROP	PROP
PRPTY	PROP
PROPRIETARY	PROPTY
PROPTY	PROPTY
PROTECTION	PROTECT
PROTCTN	PROTECT
PROTECT	PROTECT
PRTCTN	PROTECT
PROTECTIVE	PRTCTV
PRTCTV	PRTCTV
PROTESTANT	PRTSTNT
PRTSTNT	PRTSTNT
PROVIDENCE	PRVDNCE
PRVDNC	PRVDNC
PROVINCE	PROVNC
PROV	PROVNC
PROVNC	PROVNC
PROVISION	PROVSN
PROV	PROVSN
PROVSN	PROVSN
PSYCHIATRIC	PSYCHC
PSYCH	PSYCHC
PSYCHC	PSYCHC
PSYCHIATRIST	PSYCH
PSYCH	PSYCH
PSYCHIATRY	PSYCHY
PSYCH	PSYCHY
PSHYCHY	PSYCHY
PSYCHOLOGICAL	PSYCHL
PSYCH	PSYCHL
PSYCHL	PSYCHL
PSYCHOLOGIST	PSYC
PSYC	PSYC
PSYCHOLOGY	PSYCY
PSYC	PSYCY
PSYCH	PSYCY
PSYCLGY	PSYCY
PUBLIC	PUB
PBLC	PUB
PUB	PUB
PUBLICATION	PUBLCTN
PBLCNTN	PUBLCTN
PUBL	PUBLCTN
PUBLCTN	PUBLCTN
PUBLISHER	PUBLR
PBLSHR	PUBLR
PUB	PUBLR
PUBL	PUBLR
PUBLR	PUBLR
PUBLSHR	PUBLR
PUBLISHING	PBLSHNG
PBLSHNG	PBLSHNG
PUB	PBLSHNG
PUBG	PBLSHNG
PUMPING	PMPG
PMPG	PMPG
PUNCH	PNCH
PNCH	PNCH
PURCHASE	PURCH
PUR	PURCH
PURCH	PURCH
PURCHASER	PURCHR
PUR	PURCHR
PURCHR	PURCHR
PURCHASING	PRCHNG
PRCHNG	PRCHNG
PURCH	PRCHNG
QUADRANGLE	QUAD
QUAD	QUAD
QUALITY	QLTY
QLTY	QLTY
QUAL	QLTY
QULTY	QLTY
QUANTITY	QTY
QTY	QTY
QUARRY	QUAR
QUAR	QUAR
QUARTER	QTR
QTR	QTR
QUEEN	QN
QN	QN
QUICK	QCK
QCK	QCK
RABBI	RBB
RBB	RBB
RACING	RACG
RACG	RACG
RADIATOR	RADTR
RAD	RADTR
RADTR	RADTR
RADIO	RDO
RDO	RDO
RADIOLOGIST	RAD
RAD	RAD
RADIOLOGY	RADY
RAD	RADY
RADY	RADY
RAILROAD	RR
R R	RR
RR	RR
RAILWAY	RLWY
RLWY	RLWY
RAINBOW	RNBW
RNBW	RNBW
RANCH	RNCH
RNCH	RNCH
READABLE	RDBL
RDBL	RDBL
READY	RDY
RDY	RDY
REALTOR	RLTR
RLTR	RLTR
REALTY	RLTY
RLTY	RLTY
REBUILDER	RBLDR
RBLDR	RBLDR
RECEIPT	RECPT
REC	RECPT
RECP	RECPT
RECPT	RECPT
RECEIVABLE	RCVBL
RCV	RCVBL
RECEIVE	RCV
RCV	RCV
RECEIVED	RCVD
RCVD	RCVD
RECEIVING	RCVNG
RCVNG	RCVNG
RECONSTRUCTIVE	RECNSTRCTV
RECNSTRCTV	RECNSTRCTV
RECORD	REC
REC	REC
RECOVERY	RECVY
RECVY	RECVY
RECREATION	RCRTN
RCRTN	RCRTN
REC	RCRTN
RECREATIONAL	RCRTNL
RCRTNL	RCRTNL
RECRTL	RCRTNL
RECRUITER	RCRTR
RCRTR	RCRTR
RECRUITING	RECRUIT
RECRUIT	RECRUIT
RECYCLING	RECYCLE
RCYCLNG	RECYCLE
RECYCLE	RECYCLE
REDUCTION	RDCTN
RDCTN	RDCTN
REFERENCE	REF
REF	REF
REFINERY	RFNRY
RFNRY	RFNRY
REFINING	RFNG
REF	RFNG
RFNG	RFNG
REFRACTORY	REFR
REFR	REFR
REFRIGERATION	REFRIG
REFRIG	REFRIG
RFRGRTN	REFRIG
REFRIGERATOR	RFRG
RFRG	RFRG
REGION	REGN
REG	REGN
REGN	REGN
REGIONAL	REGL
REG	REGL
REGL	REGL
REGNL	REGL
REGISTER	REG
REG	REG
RGSTR	REG
REGISTERED	REGD
REG	REGD
REGD	REGD
REGISTRAR	REGR
REG	REGR
REGR	REGR
REGISTRY	RGSTY
RGSTY	RGSTY
REGULATORY	RGLTRY
RGLTRY	RGLTRY
REHABILITATION	REHAB
REHAB	REHAB
RELATED	RLTD
RLTD	RLTD
RELATION	REL
REL	REL
RELA	REL
RELIABLE	RELI
RELI	RELI
RELOCATION	RLCTN
RLCTN	RLCTN
REMEDIAL	RMDL
RMDL	RMDL
REMODELING	REMOD
REMOD	REMOD
RMDLG	REMOD
RENTAL	RENT
RENT	RENT
RNT	RENT
RNTL	RENT
REPAIR	RPR
REPR	RPR
RPR	RPR
REPORT	REPT
REP	REPT
REPT	REPT
REPORTER	REPTR
REP	REPTR
REPTR	REPTR
REPRESENTATIVE	REP
REP	REP
REPUBLIC	REPB
REPB	REPB
REPUBLICAN	REPUB
REPUB	REPUB
REQUIREMENT	RQRMNT
RQRMNT	RQRMNT
RESEARCH	RSRCH
RES	RSRCH
RSCH	RSRCH
RSRCH	RSRCH
RESERVE	RESV
RESV	RESV
RESIDENCE	RSDNC
RSDNC	RSDNC
RESIDENT	RES
RES	RES
RSDNT	RES
RESORT	RESRT
RESRT	RESRT
RESOURCE	RESRC
RES	RESRC
RESRC	RESRC
RSCE	RESRC
RSRC	RESRC
RESPONSIBLE	RESP
RESP	RESP
RESTAURANT	RSTRNT
RSTRNT	RSTRNT
RESTORATION	RESTOR
RESTOR	RESTOR
RSTRTN	RESTOR
RETAIL	RTL
RTL	RTL
RETAILER	RET
RET	RET
RETARDATION	RTRDTN
RTRDTN	RTRDTN
RETIRED	RTRD
RET	RTRD
RTRD	RTRD
RETIREMENT	RTRMNT
RTRMNT	RTRMNT
RETRAINING	RETRNG
RETRNG	RETRNG
REVEREND	REV
REV	REV
RIDGE	RDG
RDG	RDG
RIVER	RIV
RIV	RIV
RIVR	RIV
RVR	RIV
ROADWAY	RDWY
RDWY	RDWY
ROCKY	RCKY
RCKY	RCKY
ROOFING	ROOF
ROOF	ROOF
ROOFG	ROOF
ROUND	RND
RND	RND
ROUTE	RT
RT	RT
RTE	RT
ROYAL	RYL
RYL	RYL
ROYALTY	ROY
ROY	ROY
RUBBER	RBR
RBR	RBR
RURAL	RUR
RUR	RUR
SADDLERY	SAD
SAD	SAD
SAFETY	SFTY
SFTY	SFTY
SAINT	ST
ST	ST
SALES	SLS
SLS	SLS
SALESMAN	SLSMN
SLSMAN	SLSMN
SLSMN	SLSMN
SALON	SLN
SLN	SLN
SALOON	SLON
SLN	SLON
SLON	SLON
SALVAGE	SLVG
SALV	SLVG
SLVG	SLVG
SALVATION	SLVTN
SLVTN	SLVTN
SANDWICH	SNDWCH
SAND	SNDWCH
SNDWCH	SNDWCH
SANITARY	SANI
SANI	SANI
SANITATION	SANITN
SANI	SANITN
SANITN	SANITN
SATELLITE	SAT
SAT	SAT
SATISFACTION	STSFCTN
STSFCTN	STSFCTN
SAVINGS	SVNGS
SAV	SVNGS
SAVE	SVNGS
SVNGS	SVNGS
SCHOOL	SCHL
SCH	SCHL
SCHL	SCHL
SCIENCE	SCI
SC	SCI
SCI	SCI
SCIENTIFIC	SCNTFC
SCI	SCNTFC
SCNTFC	SCNTFC
SCIENTIST	SCNTST
SCNTST	SCNTST
SCREEN	SCRN
SCRN	SCRN
SEAFOOD	SEAFD
SEAFD	SEAFD
SEAMAN	SMN
SMN	SMN
SEASON	SN
SN	SN
SECOND	2ND
II	2ND
SEC	2ND
2	2ND
2ND	2ND
SECRETARIAL	SECL
SEC	SECL
SECL	SECL
SECRETARY	SECY
SEC	SECY
SECR	SECY
SECT	SECY
SECTY	SECY
SECY	SECY
SECTION	SECT
SCTN	SECT
SECT	SECT
SECTIONAL	SECTL
SECT	SECTL
SECTL	SECTL
SECURITY	SEC
SCRTY	SEC
SEC	SEC
SEMINARY	SMRY
SMRY	SMRY
SENATOR	SEN
SEN	SEN
SENIOR	SR
SR	SR
SENSORY	SNSRY
SNSRY	SNSRY
SEPTIC	SPTC
SPTC	SPTC
SERGEANT	SGT
SEGT	SGT
SERGNT	SGT
SG	SGT
SGT	SGT
SERIAL	SER
SER	SER
SERVICE	SVC
SER	SVC
SERV	SVC
SERVIC	SVC
SRV	SVC
SV	SVC
SVC	SVC
SVCE	SVC
SEVENTH	7TH
VII	7TH
7TH	7TH
SEWER	SWR
SWR	SWR
SEWING	SEW
SEW	SEW
SHADE	SHD
SHD	SHD
SHEAR	SHR
SHR	SHR
SHEET	SHT
SHT	SHT
SHELL	SHL
SHL	SHL
SHERIFF	SHER
SH	SHER
SHER	SHER
SHERIF	SHER
SHIELD	SHLD
SHLD	SHLD
SHIFT	SHFT
SHFT	SHFT
SHIPBUILDING	SHIPBLDG
SHIPBLDG	SHIPBLDG
SHIPPING	SHIPG
SHIPG	SHIPG
SHPNG	SHIPG
SHOPPE	SHP
SHP	SHP
SHOPPING	SHPG
SHOPG	SHPG
SHORE	SHOR
SHOR	SHOR
SHR	SHOR
SHOWCASE	SHWCS
SHWCS	SHWCS
SIDING	SIDE
SIDE	SIDE
SILVER	SLVR
SLVR	SLVR
SILVERPLATING	SILPLTG
SILPLTG	SILPLTG
SILVERWARE	SILWR
SILWR	SILWR
SISTER	SIS
SIS	SIS
SR	SIS
SIXTH	6TH
VI	6TH
6TH	6TH
SKILL	SKLL
SKLL	SKLL
SMALL	SM
SM	SM
SML	SM
SMELTING	SMELT
SMELT	SMELT
SOCIAL	SCL
SCL	SCL
SOC	SCL
SOCIETY	SCTY
SCTY	SCTY
SOC	SCTY
SOFTWARE	SFTWR
SFTWE	SFTWR
SFTWR	SFTWR
SOFT	SFTWR
SOLAR	SLR
SLR	SLR
SOLICITOR	SOLCR
SOLCR	SOLCR
SOLID	SLD
SLD	SLD
SOLUTION	SLTN
SLTN	SLTN
SOUND	SND
SND	SND
SOURCE	SRC
SRC	SRC
SOUTHERN	STHRN
STHRN	STHRN
SOUTHSIDE	STHSD
STHSD	STHSD
SOUVENIR	SUV
SUV	SUV
SPACE	SP
SP	SP
SPC	SP
SPECIAL	SPEC
SPCL	SPEC
SPEC	SPEC
SPECIALIST	SPCLST
SPCLST	SPCLST
SPEC	SPCLST
SPECIALIT	SPCLST
SPECIALTY	SPCLTY
SPC	SPCLTY
SPCLT	SPCLTY
SPCLTY	SPCLTY
SPEC	SPCLTY
SPECIFICATION	SPCFCTN
SPCFCTN	SPCFCTN
SPECTRUM	SPECT
SPECT	SPECT
SPEED	SPD
SPD	SPD
SPEEDOMETER	SPDMTR
SPDMTR	SPDMTR
SPEEDY	SPDY
SPDY	SPDY
SPONSOR	SPON
SPONG	SPON
SPONSORING	SPONG
SPORT	SPRT
SPRT	SPRT
SPT	SPRT
SPORTING	SPORT
SPORT	SPORT
SPRTG	SPORT
SPTG	SPORT
SPORTSWEAR	SPORTSWR
SPORTSWR	SPORTSWR
SPRING	SPG
SPG	SPG
SPNG	SPG
SPRNG	SPG
SPRINKLER	SPRINK
SPRINK	SPRINK
SQUARE	SQ
SQ	SQ
STABLE	STBL
STBL	STBL
STAFF	STAF
STAF	STAF
STAINLESS	STNLS
STNLS	STNLS
STAMP	STMP
STMP	STMP
STAMPING	STAMPG
STAMPG	STAMPG
STANDARD	STAND
STAND	STAND
STD	STAND
START	STRT
STRT	STRT
STATE	STAT
ST	STAT
STAT	STAT
STATION	STA
STA	STA
STATN	STA
STN	STA
STATIONER	STATNR
STATNR	STATNR
STATIONARY	STATNRY
STATNRY	STATNRY
STY	STATNRY
STEAK	STK
STK	STK
STEAM	STM
STM	STM
STEEL	STL
STL	STL
STEREO	STER
STER	STER
STR	STER
STERLING	STRLNG
STRLNG	STRLNG
STOCK	STCK
STCK	STCK
STOCKHOLDER	STCKHLDR
STCKHLDR	STCKHLDR
STOCKYARD	STKYD
STKYD	STKYD
STONE	STN
STN	STN
STORAGE	STGE
STGE	STGE
STOR	STGE
STRGE	STGE
STORE	STR
STR	STR
STOREKEEPER	STRKP
STRKP	STRKP
STRATEGIC	STRTGC
STRTGC	STRTGC
STREET	STRET
ST	STRET
STRET	STRET
STRT	STRET
STRUCTURAL	STRL
STRL	STRL
STRUCTURED	STRCTRD
STRCTRD	STRCTRD
STUDENT	STDNT
STDNT	STDNT
STU	STDNT
STUDIO	STD
STD	STD
STUDY	STUD
STUD	STUD
STUFF	STFF
STFF	STFF
STYLE	STYL
STYL	STYL
STYLING	STYLG
STYL	STYLG
STYLG	STYLG
STYLIST	STYLST
STYL	STYLST
STYLST	STYLST
SUBSCRIPTION	SUBSCR
SUB	SUBSCR
SUBSC	SUBSCR
SUBSCR	SUBSCR
SUBSCRON	SUBSCR
SUBSIDIARY	SUBY
SUB	SUBY
SUBY	SUBY
SUBSTANCE	SBSTNC
SBSTNC	SBSTNC
SUBSTITUTE	SUB
SUB	SUB
SUBURBAN	SUBN
SUB	SUBN
SUBN	SUBN
SUBWAY	SBWY
SBWY	SBWY
SUGAR	SUG
SUG	SUG
SUITE	STE
STE	STE
SUMMIT	SMT
SMT	SMT
SUNDRY	SNDRY
SND	SNDRY
SNDRY	SNDRY
SUNRISE	SNRS
SNRS	SNRS
SUNSET	SNST
SNST	SNST
SUNSHINE	SNSHN
SNSHN	SNSHN
SUPER	SPR
SPR	SPR
SUPERINTENDENT	SUPT
SUPT	SUPT
SUPERIOR	SUPER
SPR	SUPER
SUP	SUPER
SUPER	SUPER
SUPERMARKET	SPRMRKT
SPRMKT	SPRMRKT
SPRMRKT	SPRMRKT
SUPERVISING	SUPVG
SPVNG	SUPVG
SUPVG	SUPVG
SUPERVISION	SUPRVSN
SUPRVSN	SUPRVSN
SUPERVISOR	SUPVSR
SPV	SUPVSR
SPVR	SUPVSR
SPVSR	SUPVSR
SUPER	SUPVSR
SUPV	SUPVSR
SUPVR	SUPVSR
SUPVSR	SUPVSR
SUPERVISORY	SUPVRY
SUPVRY	SUPVRY
SUPPLY	SUPL
SPLY	SUPL
SUP	SUPL
SUPL	SUPL
SUPLY	SUPL
SUPPORT	SPPRT
SPPRT	SPPRT
SPRT	SPPRT
SUPREME	SPRM
SPRM	SPRM
SURFACE	SURFC
SRFC	SURFC
SURFC	SURFC
SURGEON	SRGN
SRGN	SRGN
SURGERY	SURG
SRGRY	SURG
SURG	SURG
SURGY	SURG
SURGICAL	SURGCL
SURGCL	SURGCL
SURPLUS	SURPL
SRPLS	SURPL
SURPL	SURPL
SURVEY	SRVY
SRVY	SRVY
SURVEYOR	SURVYR
SURVYR	SURVYR
SUSPENSION	SUSPNSN
SUSPNSN	SUSPNSN
SWEEP	SWP
SWP	SWP
SWEET	SWT
SWT	SWT
SYNDICATE	SYND
SINDICATE	SYND
SYNTHETIC	SYNT
SYNT	SYNT
SYSTEM	SYST
SYS	SYST
SYST	SYST
TABLE	TBL
TBL	TBL
TACKLE	TCKL
TCKL	TCKL
TAILOR	TLR
TLR	TLR
TAILORING	TLRG
TLRG	TLRG
TANNING	TAN
TAN	TAN
TAVERN	TRVN
TAV	TRVN
TRVN	TRVN
TAXIDERMY	TXDRMY
TXDRMY	TXDRMY
TEACHER	TEACH
TEACH	TEACH
TECHNICAL	TECHL
TECH	TECHL
TECHL	TECHL
TECHNICIAN	TECHN
TECH	TECHN
TECHN	TECHN
TECHNOLOGICAL	TCHNLGCL
TCHNLGCL	TCHNLGCL
TECHNOLOGIST	TECH
TECH	TECH
TECHNOLOGY	TECHLGY
TCHNLGY	TECHLGY
TECH	TECHLGY
TECHLGY	TECHLGY
TECHNOL	TECHLGY
TELECOMMUNICATION	TELECOM
TELCOMMN	TELECOM
TELECOM	TELECOM
TELECOMM	TELECOM
TELEGRAPH	TELG
TELG	TELG
TELEMARKETING	TELMKTG
TELMKTG	TELMKTG
TELEPHONE	TEL
PHONE	TEL
TELE	TEL
TELETYPE	TLTYP
TLTYP	TLTYP
TELEVISION	TV
T V	TV
TELEX	TLX
TLX	TLX
TEMPERATURE	TEMP
TEMP	TEMP
TEMPLE	TMPL
TMPL	TMPL
TEMPORARY	TEMPY
TEMP	TEMPY
TEMPY	TEMPY
TENNIS	TEN
TEN	TEN
TENTH	10TH
X	10TH
10TH	10TH
TERMINAL	TRMNL
TRML	TRMNL
TRMNL	TRMNL
TERMITE	TRMT
TRMT	TRMT
TERRACE	TER
TER	TER
TERR	TER
TESTING	TEST
TEST	TEST
TSTG	TEST
TEXTILE	TXTL
TEX	TXTL
TXTL	TXTL
THEATRE	THTR
THTR	THTR
THEATRICAL	THEA
THEA	THEA
THTRCL	THEA
THERAPIST	THRPST
THRPST	THRPST
THERAPY	THRPY
THRPY	THRPY
THING	THNG
THNG	THNG
THIRD	3RD
III	3RD
3	3RD
3RD	3RD
THREAD	THD
THD	THD
THRIFT	THRFT
THRFT	THRFT
THRIFTY	THRFTY
THRFT	THRFTY
THRFTY	THRFTY
THRUWAY	THRWY
THRWY	THRWY
TIMBER	TMBR
TMBR	TMBR
TITLE	TITL
TITL	TITL
TTL	TITL
TOBACCO	TOB
TOB	TOB
TOILET	TOIL
TOIL	TOIL
TOTAL	TTL
TTL	TTL
TOUCH	TCH
TCH	TCH
TOWER	TWR
TWR	TWR
TOWING	TOW
TOW	TOW
TOWN	TWN
TWN	TWN
TOWNE	TWNE
TWN	TWNE
TWNE	TWNE
TOWNSHIP	TWP
TWNSHP	TWP
TWP	TWP
TRACTOR	TRCTR
TRCTR	TRCTR
TRADE	TRD
TRD	TRD
TRADESMAN	TRDSMN
TRDSMN	TRDSMN
TRADING	TRADE
TRADE	TRADE
TRDG	TRADE
TRAFFIC	TRFC
TRFC	TRFC
TRAIL	TRL
TRL	TRL
TRAILER	TRLR
TRLR	TRLR
TRAINEE	TRN
TRN	TRN
TRAINER	TRNR
TRNR	TRNR
TRAINING	TRAIN
TRAIN	TRAIN
TRNG	TRAIN
TRANSFER	TRNSFR
TRANSF	TRNSFR
TRNSFR	TRNSFR
TRANSFORMER	TRANSFRMR
TRANS	TRANSFRMR
TRANSFRMR	TRANSFRMR
TRANSIT	TRAN
TRAN	TRAN
TRNST	TRAN
TRANSMISSION	TRANS
TRANS	TRANS
TRANSM	TRANS
TRANSMSSN	TRANS
TRANSPORT	TRNSPRT
TRANS	TRNSPRT
TRNSPRT	TRNSPRT
TRNSPT	TRNSPRT
TRANSPORTATION	TRNSPRTN
TRANSP	TRNSPRTN
TRNSP	TRNSPRTN
TRNSPRTN	TRNSPRTN
TRNSPTN	TRNSPRTN
TRAVEL	TRVL
TRVL	TRVL
TREASURE	TREAS
TREAS	TREAS
TREASURER	TRES
TR	TRES
TREA	TRES
TREAS	TRES
TRES	TRES
TRS	TRES
TREASURY	TRSRY
TRSRY	TRSRY
TREATMENT	TRTMNT
TRTMNT	TRTMNT
TRIANGLE	TRI
TRI	TRI
TRINITY	TRNTY
TRNTY	TRNTY
TRIPLE	TRPL
TRPL	TRPL
TROOPER	TRPR
TRPR	TRPR
TROPHY	TROPH
TROPH	TROPH
TROPICAL	TRPCL
TRPCL	TRPCL
TRUCK	TRCK
TRCK	TRCK
TRUCKING	TRCKNG
TRCKG	TRCKNG
TRCKNG	TRCKNG
TRUST	TRST
TR	TRST
TRST	TRST
TRUSTEE	TR
TR	TR
TRSTE	TR
TURNPIKE	TPKE
TPK	TPKE
TPKE	TPKE
TYPESETTING	TYPSG
TYPSG	TYPSG
TYPEWRITER	TYPWRTR
TYPTR	TYPWRTR
TYPWRTR	TYPWRTR
UNDERGRADUATE	UNDGRAD
UNDGRAD	UNDGRAD
UNDERGROUND	UNDGRD
UNDGRD	UNDGRD
UNDERWEAR	UNDWR
UNDWR	UNDWR
UNDERWRITER	UNDERWRTR
UNDERWRTR	UNDERWRTR
UNDRWRTR	UNDERWRTR
UNDERWRITING	UNDERWRTNG
UNDERWRTNG	UNDERWRTNG
UNIFORM	UNFRM
UNF	UNFRM
UNFRM	UNFRM
UNIF	UNFRM
UNION	UN
UN	UN
UNIQUE	UNQ
UNQ	UNQ
UNITED	UNTD
UNTD	UNTD
UNITED STATES	US
US	US
UNITED STATES OF AMERICA	USA
UNIVERSAL	UNIVRSL
UNIV	UNIVRSL
UNIVRSL	UNIVRSL
UNIVERSITY	UNIV
UNIV	UNIV
UNLIMITED	UNLTD
UNLTD	UNLTD
UPHOLSTERER	UPHLR
UPHLR	UPHLR
UPHOLSTERING	UPHLSTRNG
UPHLSTR	UPHLSTRNG
UPHLSTRNG	UPHLSTRNG
UPHOL	UPHLSTRNG
UPHOLSTERY	UPHLSTRY
UPHL	UPHLSTRY
UPHLSTRY	UPHLSTRY
UPHOL	UPHLSTRY
URANIUM	URNM
URNM	URNM
UROLOGY	URO
URO	URO
UTILITY	UTLTY
UTLTY	UTLTY
UTILIZATION	UTLZTN
UTLZTN	UTLZTN
VACUUM	VCM
VAC	VCM
VCM	VCM
VALLEY	VLY
VALLY	VLY
VLLY	VLY
VLY	VLY
VALUE	VAL
VAL	VAL
VARIETY	VRTY
VAR	VRTY
VRTY	VRTY
VAULT	VLT
VLT	VLT
VEGETABLE	VEG
VEG	VEG
VEHICLE	VEHIC
VEHIC	VEHIC
VEHK	VEHIC
VENDING	VNDNG
VEND	VNDNG
VNDNG	VNDNG
VENTILATING	VENT
VENT	VENT
VETERAN	VETRN
VET	VETRN
VETRN	VETRN
VETERINARIAN	VET
VET	VET
VETRN	VET
VETERINARY	VETRNRY
VET	VETRNRY
VETRNRY	VETRNRY
VIADUCT	VIA
VIA	VIA
VICE	V
V	V
VICTORY	VCTRY
VCTRY	VCTRY
VIDEO	VID
VID	VID
VIKING	VKG
VKG	VKG
VILLAGE	VLG
VLG	VLG
VISION	VSN
VSN	VSN
VISITING	VSTNG
VSTNG	VSTNG
VISITOR	VSTR
VSTR	VSTR
VISTA	VIS
VIS	VIS
VISUAL	VISL
VIS	VISL
VISL	VISL
VOCATION	VOCN
VOCN	VOCN
VOCATIONAL	VOCNL
VOCNL	VOCNL
VOLUME	VOL
VOL	VOL
VOLUNTARY	VOLNTRY
VOL	VOLNTRY
VOLNTRY	VOLNTRY
VOLUNTEER	VOLNTR
VULCANIZATION	VULCN
VULCN	VULCN
VUCANIZING	VULC
VULC	VULC
WALKWAY	WLKWY
WLKWY	WLKWY
WALLPAPER	WLPAPER
PAPER	WLPAPER
WLPAPER	WLPAPER
WLPR	WLPAPER
WARDEN	WRDN
WRDN	WRDN
WAREHOUSE	WRHSE
WHSE	WRHSE
WRHSE	WRHSE
WAREHOUSING	WHSNG
WHSNG	WHSNG
WARRANT	WRRNT
WRRNT	WRRNT
WASHING	WSHG
WSHG	WSHG
WASTE	WST
WST	WST
WASTEWATER	WSTWTR
WSTWTR	WSTWTR
WATER	WTR
WTR	WTR
WEBER	WBR
WBR	WBR
WEIGHT	WGHT
WGHT	WGHT
WT	WGHT
WELDING	WELD
WELD	WELD
WLDG	WELD
WESTERN	WSTRN
WSTRN	WSTRN
WESTSIDE	WSTSD
WSTSD	WSTSD
WHEEL	WHL
WHL	WHL
WHEELER	WHLR
WHLR	WHLR
WHITE	WHT
WHT	WHT
WHOLESALE	WHOL
WHLSE	WHOL
WHOL	WHOL
WHS	WHOL
WHSE	WHOL
WHSL	WHOL
WHOLESALER	WHSLR
WHSLR	WHSLR
WINDOW	WNDW
WIN	WNDW
WNDW	WNDW
WIRING	WIRG
WIRG	WIRG
WITNESS	WTNS
WTNS	WTNS
WOMEN	WMN
WM	WMN
WMN	WMN
WOODWORK	WOODWK
WOODWK	WOODWK
WOODWORKING	WOODWKG
WDWKG	WOODWKG
WOODWKG	WOODWKG
WOOLEN	WOOL
WOOL	WOOL
WORKER	WRKR
WKR	WRKR
WRKR	WRKR
WORKING	WKG
WKG	WKG
WORKSHOP	WRKSHP
WRKSHP	WRKSHP
WORLD	WLD
WLD	WLD
WRLD	WLD
WORLDWIDE	WRLDWD
WRLDWD	WRLDWD
WRECKER	WRCKR
WRCKR	WRCKR
WRECKING	WRCKG
WRCKG	WRCKG
WRITER	WRTR
WRTR	WRTR
YACHT	YCHT
YCHT	YCHT
YELLOW	YLW
YLW	YLW
YOGURT	YGRT
YGRT	YGRT
YOUNG	YNG
YNG	YNG
YOUTH	YTH
YTH	YTH
